casualty_id,event_id,deaths_a,deaths_b,deaths_civilians,death_unknown,best,high,low
1,147997,0,5,0,0,5,5,5
2,149221,0,0,0,1,1,1,1
3,149248,10,4,0,12,26,26,26
4,149249,0,0,0,2,2,2,2
5,149251,0,0,0,6,6,6,6
6,149250,2,46,0,0,48,67,48
7,153030,0,0,0,45,45,45,45
8,149866,1,2,0,0,3,3,3
9,149868,0,0,0,1,1,1,1
10,419757,0,0,1,0,1,1,0
11,149876,0,3,0,0,3,3,3
12,149879,0,0,0,0,0,4,0
13,398179,1,0,0,0,1,1,1
14,398183,1,0,0,0,1,1,1
15,149973,1,3,0,0,4,4,4
16,152957,0,5,0,0,5,5,5
17,399045,1,0,0,0,1,1,0
18,399046,1,0,0,0,1,1,0
19,399063,5,0,0,0,5,5,5
20,399053,1,0,0,0,1,1,1
21,153027,0,3,2,0,5,5,5
22,153037,1,0,0,0,1,1,1
23,153149,0,0,0,0,0,10,0
24,153143,5,0,0,5,10,10,10
25,153433,0,0,0,1,1,1,1
26,153154,4,4,2,0,10,35,9
27,153435,6,7,0,0,13,21,13
28,400158,1,0,0,0,1,1,1
29,153997,7,0,0,0,7,7,6
30,154007,1,0,0,0,1,1,1
31,400186,1,0,0,0,1,1,0
32,154030,16,1,0,0,17,17,17
33,417904,1,0,0,0,1,1,1
34,154034,5,10,0,0,15,16,15
35,400197,3,0,0,0,3,3,3
36,400200,1,0,0,0,1,1,1
37,406991,1,0,0,0,1,1,1
38,154047,0,0,2,0,2,2,2
39,154049,0,0,0,1,1,1,1
40,154050,0,50,0,0,50,50,48
41,154054,2,0,0,0,2,2,2
42,406994,1,0,0,0,1,1,0
43,154058,12,0,0,0,12,12,12
44,154062,0,1,0,0,1,1,1
45,406995,1,0,0,0,1,1,1
46,406996,1,0,0,0,1,1,1
47,154067,0,10,0,0,10,10,10
48,154068,1,0,0,0,1,1,1
49,407090,1,0,0,0,1,1,0
50,154070,0,40,0,0,40,40,0
51,154177,0,0,2,0,2,2,2
52,407094,2,0,0,0,2,2,2
53,407096,1,0,0,0,1,1,1
54,407098,1,0,0,0,1,1,1
55,407100,1,0,0,0,1,1,1
56,407136,1,0,0,0,1,1,1
57,154072,0,5,0,0,5,5,5
58,154074,0,50,0,0,50,50,50
59,154156,5,0,0,0,5,5,5
60,407173,1,0,0,0,1,1,1
61,154179,16,0,0,0,16,16,16
62,154178,0,0,2,0,2,2,2
63,154405,1,0,0,0,1,1,1
64,154404,0,0,0,5,5,5,5
65,154182,9,0,0,0,9,9,9
66,407195,2,0,0,0,2,2,2
67,407196,1,0,0,0,1,1,1
68,154409,3,0,0,0,3,3,3
69,154410,0,0,1,0,1,1,1
70,154412,1,0,0,0,1,1,1
71,407199,1,0,0,0,1,1,0
72,407200,1,0,0,0,1,1,1
73,407305,1,0,0,0,1,1,1
74,418937,1,0,0,0,1,1,1
75,154734,0,0,0,0,0,12,0
76,407331,2,0,0,0,2,2,2
77,407334,1,0,0,0,1,1,1
78,392366,0,0,1,0,1,1,1
79,154413,4,0,0,0,4,4,4
80,407373,1,0,0,0,1,1,1
81,407414,2,0,0,0,2,2,0
82,407407,2,0,0,0,2,2,2
83,407408,7,0,0,0,7,7,7
84,407409,1,0,0,0,1,1,1
85,407410,1,0,0,0,1,1,1
86,407413,1,0,0,0,1,1,1
87,407417,1,0,0,0,1,1,1
88,154633,3,0,0,0,3,3,3
89,154652,1,0,0,0,1,1,1
90,407452,1,0,0,0,1,1,1
91,407453,1,0,0,0,1,1,1
92,408434,1,0,0,0,1,1,1
93,407513,1,0,0,0,1,1,1
94,407503,1,0,0,0,1,1,1
95,154666,0,0,4,0,4,4,4
96,154667,0,0,0,0,0,250,0
97,154690,0,0,7,0,7,7,7
98,407527,2,0,0,0,2,2,2
99,407529,2,0,0,0,2,2,2
100,407555,1,0,0,0,1,1,1
101,407573,1,0,0,0,1,1,1
102,407598,4,0,0,0,4,4,4
103,407615,2,0,0,0,2,2,2
104,407695,1,0,0,0,1,1,1
105,407696,1,0,0,0,1,1,1
106,154676,0,0,11,0,11,11,11
107,407710,6,0,0,0,6,16,6
108,407729,1,0,0,0,1,1,1
109,154679,0,0,298,0,298,298,298
110,407739,2,0,0,0,2,2,2
111,407740,2,0,0,0,2,2,2
112,407751,2,0,0,0,2,2,2
113,407752,1,0,0,0,1,1,0
114,154684,0,0,1,0,1,1,1
115,154683,0,0,0,5,5,5,5
116,407777,2,0,0,0,2,2,2
117,408084,3,0,0,0,3,3,3
118,408085,4,0,0,0,4,4,4
119,408087,1,0,0,0,1,1,1
120,408093,1,0,0,0,1,1,1
121,408170,1,0,0,0,1,1,1
122,408159,1,0,0,0,1,1,1
123,408161,1,0,0,0,1,1,1
124,408166,1,0,0,0,1,1,1
125,408168,1,0,0,0,1,1,1
126,408179,3,0,0,0,3,3,3
127,408241,1,0,0,0,1,1,1
128,408227,2,0,0,0,2,6,2
129,408278,1,0,0,0,1,1,1
130,408238,2,0,0,0,2,2,2
131,408234,1,0,0,0,1,1,1
132,408277,1,0,0,0,1,1,1
133,154693,0,0,3,0,3,3,3
134,154692,0,0,2,10,12,12,12
135,155076,0,0,0,5,5,5,5
136,408255,0,0,0,1,1,1,1
137,408258,1,0,0,0,1,1,1
138,408261,4,0,0,0,4,4,4
139,408273,3,0,0,0,3,3,3
140,408253,1,0,0,0,1,1,1
141,417760,1,0,0,0,1,1,1
142,408280,2,0,0,0,2,2,2
143,408281,1,0,0,0,1,1,1
144,408291,1,0,0,0,1,1,1
145,408299,3,0,0,0,3,3,3
146,408303,2,0,0,0,2,2,0
147,408306,3,0,0,0,3,3,3
148,154696,0,0,4,0,4,4,4
149,154694,0,0,5,12,17,17,17
150,154697,10,0,0,0,10,10,10
151,154698,0,0,2,0,2,2,2
152,408318,1,0,0,0,1,1,1
153,408325,2,0,0,0,2,2,2
154,408334,1,0,0,0,1,1,1
155,408329,3,0,0,0,3,3,3
156,408406,2,0,0,0,2,2,2
157,408412,1,0,0,0,1,1,1
158,408421,5,0,0,0,5,5,5
159,154702,22,0,0,0,22,22,22
160,154703,0,0,1,0,1,1,1
161,408428,1,0,0,0,1,1,1
162,408430,1,0,0,0,1,1,1
163,408431,1,0,0,0,1,1,1
164,408441,5,0,0,0,5,5,5
165,408444,1,0,0,0,1,1,1
166,408447,1,0,0,0,1,1,0
167,408448,1,0,0,0,1,1,1
168,408460,1,0,0,0,1,1,1
169,408464,1,0,0,0,1,1,1
170,408465,1,0,0,0,1,1,1
171,408466,1,0,0,0,1,1,1
172,154707,0,0,0,6,6,6,6
173,154732,0,0,0,2,2,2,2
174,408497,1,0,0,0,1,1,1
175,408502,1,0,0,0,1,1,1
176,408487,1,0,0,0,1,1,1
177,408495,1,0,0,0,1,1,1
178,154847,0,0,0,0,0,1,0
179,154999,0,0,2,0,2,2,2
180,155000,0,0,1,0,1,1,1
181,410213,1,0,0,0,1,1,1
182,410216,3,0,0,0,3,3,3
183,410220,1,0,0,0,1,1,1
184,410223,1,0,0,0,1,1,1
185,410227,1,0,0,0,1,1,1
186,410232,7,0,0,0,7,7,7
187,410250,1,0,0,0,1,1,1
188,410672,1,0,0,0,1,1,1
189,410675,5,0,0,0,5,5,5
190,410679,1,0,0,0,1,1,1
191,410634,1,0,0,0,1,1,1
192,155003,0,0,3,0,3,3,3
193,155252,0,0,1,0,1,1,1
194,155005,0,0,1,0,1,1,1
195,410713,1,0,0,0,1,1,1
196,410717,2,0,0,0,2,2,2
197,410677,3,0,0,0,3,3,3
198,410722,2,0,0,0,2,2,0
199,410724,2,0,0,0,2,2,2
200,410725,1,0,0,0,1,1,1
201,411120,1,0,0,0,1,1,1
202,410759,2,0,0,0,2,2,2
203,410761,1,0,0,0,1,1,1
204,410870,5,0,0,0,5,5,5
205,410884,1,0,0,0,1,1,1
206,410929,1,0,0,0,1,1,0
207,410930,1,0,0,0,1,1,1
208,410933,1,0,0,0,1,1,1
209,410936,1,0,0,0,1,1,1
210,410882,1,0,0,0,1,1,1
211,419893,1,0,0,0,1,1,1
212,415148,1,0,0,0,1,1,1
213,155009,0,0,1,0,1,1,1
214,410976,1,0,0,0,1,1,1
215,410978,4,0,0,0,4,4,4
216,410985,3,0,0,0,3,3,3
217,410990,2,0,0,0,2,2,2
218,411063,1,0,0,0,1,1,1
219,417631,1,0,0,0,1,1,1
220,410987,5,0,0,0,5,5,5
221,411006,2,0,0,0,2,2,2
222,411016,0,0,1,0,1,1,1
223,411019,1,0,0,0,1,1,1
224,411058,5,0,0,0,5,5,5
225,411121,1,0,0,0,1,1,1
226,411126,2,0,0,0,2,2,2
227,411130,1,0,0,0,1,1,1
228,411112,1,0,0,0,1,1,1
229,411113,9,0,0,0,9,9,9
230,155016,12,0,0,0,12,12,10
231,415062,1,0,0,0,1,1,1
232,414867,1,0,0,0,1,1,1
233,414876,1,0,0,0,1,1,1
234,414877,1,0,0,0,1,1,1
235,414882,1,0,0,0,1,1,1
236,414884,1,0,0,0,1,1,1
237,414885,1,0,0,0,1,1,0
238,414887,1,0,0,0,1,1,1
239,414889,1,0,0,0,1,1,1
240,414893,1,0,0,0,1,1,1
241,414895,1,0,0,0,1,1,1
242,155026,0,0,3,0,3,3,3
243,155109,0,100,0,0,100,100,100
244,411132,1,0,0,0,1,1,1
245,411135,1,0,0,0,1,1,1
246,411176,1,0,0,0,1,1,1
247,411180,1,0,0,0,1,1,1
248,411198,1,0,0,0,1,1,1
249,155039,0,0,0,1,1,1,1
250,155050,0,0,11,0,11,11,11
251,414919,1,0,0,0,1,1,1
252,414920,1,0,0,0,1,1,1
253,414934,1,0,0,0,1,1,1
254,414935,1,0,0,0,1,1,1
255,415079,1,0,0,0,1,1,0
256,414941,1,0,0,0,1,1,1
257,414942,1,0,0,0,1,1,1
258,414943,2,0,0,0,2,2,2
259,414944,1,0,0,0,1,1,1
260,414945,1,0,0,0,1,1,1
261,414946,1,0,0,0,1,1,1
262,414952,1,0,0,0,1,1,1
263,414990,1,0,0,0,1,1,1
264,414991,1,0,0,0,1,1,1
265,414992,1,0,0,0,1,1,1
266,414993,1,0,0,0,1,1,1
267,155058,0,0,0,10,10,10,10
268,415036,1,0,0,0,1,1,1
269,415047,1,0,0,0,1,1,1
270,415050,1,0,0,0,1,1,1
271,415051,1,0,0,0,1,1,1
272,415053,1,0,0,0,1,1,1
273,415054,1,0,0,0,1,1,1
274,415055,1,0,0,0,1,1,1
275,415056,1,0,0,0,1,1,1
276,415057,1,0,0,0,1,1,1
277,415058,1,0,0,0,1,1,1
278,415059,1,0,0,0,1,1,1
279,415060,1,0,0,0,1,1,1
280,415061,1,0,0,0,1,1,1
281,415066,1,0,0,0,1,1,1
282,415102,1,0,0,0,1,1,1
283,415103,1,0,0,0,1,1,1
284,415107,1,0,0,0,1,1,1
285,415109,1,0,0,0,1,1,1
286,415111,1,0,0,0,1,1,1
287,415334,1,0,0,0,1,1,0
288,155095,0,12,0,0,12,12,12
289,155096,0,26,0,0,26,26,26
290,155090,0,0,43,0,43,43,43
291,415128,1,0,0,0,1,1,1
292,415130,1,0,0,0,1,1,1
293,415131,1,0,0,0,1,1,1
294,415132,1,0,0,0,1,1,1
295,415133,1,0,0,0,1,1,1
296,415134,1,0,0,0,1,1,1
297,415135,1,0,0,0,1,1,1
298,415153,4,0,0,0,4,4,4
299,415142,1,0,0,0,1,1,1
300,415146,1,0,0,0,1,1,1
301,155098,0,0,2,0,2,2,2
302,415177,1,0,0,0,1,1,1
303,415180,1,0,0,0,1,1,1
304,415183,1,0,0,0,1,1,1
305,415186,1,0,0,0,1,1,1
306,415187,1,0,0,0,1,1,1
307,415162,1,0,0,0,1,1,1
308,415164,1,0,0,0,1,1,1
309,415165,4,0,0,0,4,4,4
310,415167,1,0,0,0,1,1,1
311,415172,2,0,0,0,2,2,2
312,415173,1,0,0,0,1,1,1
313,415174,1,0,0,0,1,1,1
314,415203,1,0,0,0,1,1,1
315,415207,1,0,0,0,1,1,1
316,415208,1,0,0,0,1,1,1
317,415210,1,0,0,0,1,1,1
318,415211,2,0,0,0,2,2,2
319,415212,3,0,0,0,3,3,3
320,415227,3,0,0,0,3,3,3
321,415228,8,0,0,0,8,8,8
322,415233,1,0,0,0,1,1,1
323,415236,1,0,0,0,1,1,1
324,415238,1,0,0,0,1,1,1
325,415239,1,0,0,0,1,1,1
326,415241,3,0,0,0,3,3,3
327,415245,1,0,0,0,1,1,1
328,415246,1,0,0,0,1,1,1
329,415247,1,0,0,0,1,1,1
330,415250,1,0,0,0,1,1,1
331,415222,1,0,0,0,1,1,1
332,415276,1,0,0,0,1,1,1
333,415277,1,0,0,0,1,1,1
334,415278,1,0,0,0,1,1,1
335,415279,2,0,0,0,2,2,2
336,415321,1,0,0,0,1,1,1
337,415275,1,0,0,0,1,1,1
338,415269,1,0,0,0,1,1,1
339,415271,1,0,0,0,1,1,1
340,415272,2,0,0,0,2,2,2
341,415254,1,0,0,0,1,1,1
342,415255,1,0,0,0,1,1,1
343,415256,1,0,0,0,1,1,1
344,415257,1,0,0,0,1,1,1
345,415258,1,0,0,0,1,1,1
346,415259,1,0,0,0,1,1,1
347,415260,1,0,0,0,1,1,1
348,415261,1,0,0,0,1,1,1
349,155103,0,0,3,0,3,3,3
350,415282,1,0,0,0,1,1,1
351,415292,4,0,0,0,4,4,4
352,415311,1,0,0,0,1,1,1
353,415313,1,0,0,0,1,1,1
354,416801,1,0,0,0,1,1,1
355,416804,1,0,0,0,1,1,1
356,415394,1,0,0,0,1,1,1
357,417899,1,0,0,0,1,1,1
358,415331,1,0,0,0,1,1,1
359,415332,1,0,0,0,1,1,1
360,415333,1,0,0,0,1,1,1
361,415335,1,0,0,0,1,1,1
362,415340,1,0,0,0,1,1,1
363,415341,1,0,0,0,1,1,1
364,415342,1,0,0,0,1,1,1
365,415343,1,0,0,0,1,1,1
366,415344,1,0,0,0,1,1,1
367,415345,1,0,0,0,1,1,1
368,415346,1,0,0,0,1,1,1
369,415347,4,0,0,0,4,4,4
370,415348,3,0,0,0,3,3,3
371,415349,1,0,0,0,1,1,1
372,415350,1,0,0,0,1,1,1
373,155108,0,0,15,0,15,15,15
374,415352,9,0,0,0,9,9,9
375,415353,1,0,0,0,1,1,1
376,415398,2,0,0,0,2,2,2
377,415399,1,0,0,0,1,1,1
378,415400,1,0,0,0,1,1,1
379,415401,1,0,0,0,1,1,1
380,415402,1,0,0,0,1,1,1
381,415424,1,0,0,0,1,1,1
382,415425,1,0,0,0,1,1,1
383,415429,1,0,0,0,1,1,1
384,415430,1,0,0,0,1,1,1
385,415431,1,0,0,0,1,1,1
386,415432,1,0,0,0,1,1,1
387,415434,1,0,0,0,1,1,1
388,415435,1,0,0,0,1,1,1
389,415436,1,0,0,0,1,1,1
390,415437,1,0,0,0,1,1,1
391,415438,1,0,0,0,1,1,1
392,415439,1,0,0,0,1,1,1
393,415441,1,0,0,0,1,1,1
394,415442,1,0,0,0,1,1,1
395,415444,1,0,0,0,1,1,1
396,415445,1,0,0,0,1,1,1
397,415446,1,0,0,0,1,1,1
398,415447,1,0,0,0,1,1,1
399,416755,1,0,0,0,1,1,1
400,415475,1,0,0,0,1,1,1
401,415476,1,0,0,0,1,1,1
402,415477,1,0,0,0,1,1,1
403,415478,1,0,0,0,1,1,1
404,415481,1,0,0,0,1,1,1
405,415492,1,0,0,0,1,1,1
406,415493,1,0,0,0,1,1,1
407,415494,1,0,0,0,1,1,1
408,415495,1,0,0,0,1,1,1
409,415496,1,0,0,0,1,1,1
410,415511,1,0,0,0,1,1,1
411,415513,1,0,0,0,1,1,1
412,415518,1,0,0,0,1,1,1
413,415519,1,0,0,0,1,1,1
414,415521,1,0,0,0,1,1,1
415,415523,1,0,0,0,1,1,1
416,415526,1,0,0,0,1,1,1
417,415527,1,0,0,0,1,1,1
418,415541,1,0,0,0,1,1,1
419,415542,1,0,0,0,1,1,1
420,415543,1,0,0,0,1,1,1
421,415544,1,0,0,0,1,1,1
422,415545,1,0,0,0,1,1,1
423,415546,1,0,0,0,1,1,1
424,415558,1,0,0,0,1,1,1
425,415560,1,0,0,0,1,1,1
426,415566,1,0,0,0,1,1,1
427,415567,1,0,0,0,1,1,1
428,415568,1,0,0,0,1,1,1
429,415570,1,0,0,0,1,1,1
430,415571,1,0,0,0,1,1,1
431,415572,1,0,0,0,1,1,1
432,415574,1,0,0,0,1,1,1
433,415575,1,0,0,0,1,1,1
434,415579,1,0,0,0,1,1,1
435,415582,1,0,0,0,1,1,1
436,415584,1,0,0,0,1,1,1
437,415585,1,0,0,0,1,1,1
438,416803,1,0,0,0,1,1,1
439,415483,1,0,0,0,1,1,1
440,415491,1,0,0,0,1,1,1
441,415599,3,0,0,0,3,3,3
442,415600,1,0,0,0,1,1,1
443,415601,1,0,0,0,1,1,1
444,415604,1,0,0,0,1,1,1
445,415605,1,0,0,0,1,1,1
446,415615,1,0,0,0,1,1,1
447,415616,3,0,0,0,3,3,3
448,415618,1,0,0,0,1,1,1
449,415619,1,0,0,0,1,1,1
450,415620,1,0,0,0,1,1,1
451,415621,1,0,0,0,1,1,1
452,415622,1,0,0,0,1,1,1
453,415630,1,0,0,0,1,1,1
454,415631,1,0,0,0,1,1,1
455,415634,1,0,0,0,1,1,1
456,415635,1,0,0,0,1,1,1
457,415638,1,0,0,0,1,1,1
458,415639,1,0,0,0,1,1,1
459,415646,1,0,0,0,1,1,1
460,415647,1,0,0,0,1,1,1
461,415649,1,0,0,0,1,1,1
462,415650,1,0,0,0,1,1,1
463,415652,1,0,0,0,1,1,1
464,415653,1,0,0,0,1,1,1
465,415655,1,0,0,0,1,1,1
466,415656,1,0,0,0,1,1,1
467,415659,1,0,0,0,1,1,1
468,415660,1,0,0,0,1,1,1
469,415661,1,0,0,0,1,1,1
470,415662,1,0,0,0,1,1,1
471,415663,1,0,0,0,1,1,1
472,415664,1,0,0,0,1,1,1
473,415665,1,0,0,0,1,1,1
474,415668,1,0,0,0,1,1,1
475,415669,1,0,0,0,1,1,1
476,415671,1,0,0,0,1,1,1
477,415673,1,0,0,0,1,1,1
478,415674,1,0,0,0,1,1,1
479,415675,1,0,0,0,1,1,1
480,415676,1,0,0,0,1,1,1
481,415677,1,0,0,0,1,1,1
482,415678,1,0,0,0,1,1,1
483,415679,1,0,0,0,1,1,1
484,415680,1,0,0,0,1,1,1
485,415681,1,0,0,0,1,1,1
486,415682,1,0,0,0,1,1,1
487,415684,1,0,0,0,1,1,1
488,415685,1,0,0,0,1,1,1
489,415686,1,0,0,0,1,1,1
490,415687,1,0,0,0,1,1,1
491,415688,1,0,0,0,1,1,1
492,415689,1,0,0,0,1,1,1
493,415690,1,0,0,0,1,1,1
494,415691,1,0,0,0,1,1,1
495,415692,1,0,0,0,1,1,1
496,415693,1,0,0,0,1,1,1
497,415695,1,0,0,0,1,1,1
498,415696,1,0,0,0,1,1,1
499,415697,1,0,0,0,1,1,1
500,415698,1,0,0,0,1,1,1
501,415699,1,0,0,0,1,1,1
502,415700,1,0,0,0,1,1,1
503,415702,1,0,0,0,1,1,1
504,415703,1,0,0,0,1,1,1
505,415709,1,0,0,0,1,1,1
506,415710,1,0,0,0,1,1,1
507,415712,1,0,0,0,1,1,1
508,415713,1,0,0,0,1,1,1
509,415716,1,0,0,0,1,1,1
510,415718,1,0,0,0,1,1,1
511,415719,1,0,0,0,1,1,1
512,415720,1,0,0,0,1,1,1
513,415721,1,0,0,0,1,1,1
514,415722,1,0,0,0,1,1,1
515,415723,1,0,0,0,1,1,1
516,415724,1,0,0,0,1,1,1
517,415727,1,0,0,0,1,1,1
518,415729,1,0,0,0,1,1,1
519,415732,1,0,0,0,1,1,1
520,415733,1,0,0,0,1,1,1
521,415734,1,0,0,0,1,1,1
522,415735,1,0,0,0,1,1,1
523,415771,1,0,0,0,1,1,1
524,415772,1,0,0,0,1,1,1
525,415773,1,0,0,0,1,1,1
526,415774,1,0,0,0,1,1,1
527,415775,1,0,0,0,1,1,1
528,415776,1,0,0,0,1,1,1
529,415777,1,0,0,0,1,1,1
530,415778,1,0,0,0,1,1,1
531,415779,1,0,0,0,1,1,1
532,415780,1,0,0,0,1,1,1
533,415781,1,0,0,0,1,1,1
534,415782,1,0,0,0,1,1,1
535,415783,1,0,0,0,1,1,1
536,415784,1,0,0,0,1,1,1
537,415785,1,0,0,0,1,1,1
538,415786,1,0,0,0,1,1,1
539,415787,1,0,0,0,1,1,1
540,415788,1,0,0,0,1,1,1
541,416536,1,0,0,0,1,1,1
542,416539,1,0,0,0,1,1,1
543,416540,1,0,0,0,1,1,1
544,416544,1,0,0,0,1,1,1
545,416546,1,0,0,0,1,1,1
546,416547,1,0,0,0,1,1,1
547,416549,1,0,0,0,1,1,1
548,416550,1,0,0,0,1,1,1
549,416551,1,0,0,0,1,1,1
550,416554,1,0,0,0,1,1,1
551,416555,1,0,0,0,1,1,1
552,416562,1,0,0,0,1,1,1
553,416563,1,0,0,0,1,1,1
554,416564,1,0,0,0,1,1,1
555,416568,1,0,0,0,1,1,1
556,416570,1,0,0,0,1,1,1
557,416571,1,0,0,0,1,1,1
558,416572,1,0,0,0,1,1,1
559,416573,1,0,0,0,1,1,1
560,416574,1,0,0,0,1,1,1
561,416589,1,0,0,0,1,1,1
562,416590,1,0,0,0,1,1,1
563,416594,1,0,0,0,1,1,1
564,416612,1,0,0,0,1,1,1
565,416613,1,0,0,0,1,1,1
566,416614,1,0,0,0,1,1,1
567,416616,1,0,0,0,1,1,1
568,416621,1,0,0,0,1,1,1
569,416622,1,0,0,0,1,1,1
570,416623,1,0,0,0,1,1,1
571,416637,1,0,0,0,1,1,1
572,416639,1,0,0,0,1,1,1
573,416641,1,0,0,0,1,1,1
574,416643,1,0,0,0,1,1,1
575,416646,1,0,0,0,1,1,1
576,416647,1,0,0,0,1,1,1
577,416650,1,0,0,0,1,1,1
578,416652,1,0,0,0,1,1,1
579,416653,1,0,0,0,1,1,1
580,416689,1,0,0,0,1,1,1
581,416690,1,0,0,0,1,1,1
582,416691,1,0,0,0,1,1,1
583,416701,1,0,0,0,1,1,1
584,416702,1,0,0,0,1,1,1
585,416704,1,0,0,0,1,1,1
586,416723,1,0,0,0,1,1,1
587,416724,1,0,0,0,1,1,1
588,416726,1,0,0,0,1,1,1
589,416730,1,0,0,0,1,1,1
590,416731,1,0,0,0,1,1,1
591,416735,1,0,0,0,1,1,1
592,416738,1,0,0,0,1,1,1
593,416739,1,0,0,0,1,1,1
594,415386,1,0,0,0,1,1,1
595,415388,1,0,0,0,1,1,1
596,415389,1,0,0,0,1,1,1
597,415390,1,0,0,0,1,1,1
598,415391,1,0,0,0,1,1,1
599,415392,1,0,0,0,1,1,1
600,415393,1,0,0,0,1,1,1
601,415372,1,0,0,0,1,1,1
602,415373,1,0,0,0,1,1,1
603,415374,1,0,0,0,1,1,1
604,415375,1,0,0,0,1,1,1
605,415377,1,0,0,0,1,1,1
606,415378,1,0,0,0,1,1,1
607,417582,1,0,0,0,1,1,1
608,416800,1,0,0,0,1,1,0
609,429192,1,0,0,0,1,1,1
610,416758,1,0,0,0,1,1,1
611,416759,1,0,0,0,1,1,1
612,416776,2,0,0,0,2,2,2
613,416777,4,0,0,0,4,4,4
614,416798,1,0,0,0,1,1,1
615,416817,1,0,0,0,1,1,1
616,416818,1,0,0,0,1,1,1
617,416808,6,0,0,0,6,6,0
618,416809,1,0,0,0,1,1,1
619,416811,1,0,0,0,1,1,1
620,417030,1,0,0,0,1,1,1
621,417165,1,0,0,0,1,1,1
622,417011,1,0,0,0,1,1,1
623,417013,1,0,0,0,1,1,1
624,417008,1,0,0,0,1,1,1
625,155250,0,0,1,0,1,1,1
626,155251,0,0,1,0,1,1,1
627,417107,1,0,0,0,1,1,1
628,417433,1,0,0,0,1,1,0
629,417554,1,0,0,0,1,1,0
630,417141,1,0,0,0,1,1,1
631,417142,1,0,0,0,1,1,1
632,417143,1,0,0,0,1,1,1
633,417146,1,0,0,0,1,1,1
634,417147,1,0,0,0,1,1,1
635,417157,1,0,0,0,1,1,1
636,155253,0,0,1,0,1,1,1
637,155255,0,0,5,0,5,5,5
638,417158,5,0,0,0,5,5,5
639,417159,1,0,0,0,1,1,1
640,417163,1,0,0,0,1,1,1
641,417400,3,0,0,0,3,3,3
642,417290,1,0,0,0,1,1,1
643,155259,0,0,1,0,1,1,1
644,417406,1,0,0,0,1,1,1
645,417409,1,0,0,0,1,1,1
646,417426,1,0,0,0,1,1,1
647,417429,1,0,0,0,1,1,1
648,417442,3,0,0,0,3,3,3
649,417449,2,0,0,0,2,2,2
650,417522,1,0,0,0,1,1,1
651,417523,1,0,0,0,1,1,1
652,417524,1,0,0,0,1,1,1
653,417525,1,0,0,0,1,1,1
654,417526,1,0,0,0,1,1,1
655,417527,1,0,0,0,1,1,1
656,155267,0,0,6,0,6,6,6
657,417528,1,0,0,0,1,1,1
658,417534,1,0,0,0,1,1,1
659,153151,0,1,0,0,1,1,1
660,155081,0,0,0,208,208,208,208
661,154701,0,0,0,62,62,62,62
662,400194,3,0,0,0,3,3,3
663,154042,0,0,0,0,0,2,0
664,154048,0,0,0,1,1,1,1
665,154063,0,5,0,2,7,14,7
666,154065,0,6,0,0,6,6,6
667,407071,1,0,0,0,1,1,1
668,407132,1,0,0,0,1,1,1
669,407130,1,0,0,0,1,1,1
670,154073,49,0,0,0,49,49,49
671,154161,0,0,2,8,10,10,10
672,426046,2,0,0,0,2,2,2
673,407162,4,0,0,0,4,4,4
674,407168,13,0,0,0,13,13,13
675,407197,1,0,0,0,1,1,1
676,407198,2,0,0,0,2,2,2
677,407311,1,0,0,0,1,1,1
678,418935,1,0,0,0,1,1,0
679,407328,1,0,0,0,1,1,1
680,407339,1,0,0,0,1,1,1
681,154674,0,0,10,0,10,10,10
682,407372,1,0,0,0,1,1,1
683,407376,1,0,0,0,1,1,1
684,407406,1,0,0,0,1,1,1
685,154414,1,0,0,0,1,1,0
686,407411,1,0,0,0,1,1,1
687,407412,1,0,0,0,1,1,1
688,407415,1,0,0,0,1,1,1
689,407416,1,0,0,0,1,1,1
690,154655,0,0,0,0,0,50,0
691,154637,1,0,0,0,1,1,1
692,154641,3,0,0,0,3,3,3
693,154654,36,0,0,0,36,36,23
694,154669,0,0,0,0,0,250,0
695,154661,0,0,4,0,4,4,4
696,407508,2,0,0,0,2,2,2
697,407454,1,0,0,0,1,1,1
698,407456,2,0,0,0,2,2,2
699,407457,2,0,0,0,2,2,2
700,407530,1,0,0,0,1,1,1
701,407531,3,0,0,0,3,3,3
702,154662,1,0,0,0,1,1,1
703,154665,1,0,0,0,1,1,1
704,154672,0,30,0,0,30,30,30
705,407562,1,0,0,0,1,1,1
706,407568,7,0,0,0,7,7,7
707,407580,2,0,0,0,2,2,2
708,420128,1,0,0,0,1,1,1
709,407611,4,0,0,0,4,4,4
710,154677,2,0,0,0,2,2,2
711,407697,1,0,0,0,1,1,1
712,407699,9,0,0,0,9,9,9
713,407714,2,0,0,0,2,2,2
714,407721,1,0,0,0,1,1,1
715,407738,1,0,0,0,1,1,1
716,407743,6,0,0,0,6,6,6
717,407747,1,0,0,0,1,1,1
718,407749,1,0,0,0,1,1,1
719,407755,1,0,0,0,1,1,1
720,407761,1,0,0,0,1,1,1
721,407762,4,0,0,0,4,4,4
722,414811,1,0,0,0,1,1,1
723,154687,0,0,0,2,2,2,2
724,407763,1,0,0,0,1,1,1
725,407767,5,0,0,0,5,5,5
726,408140,1,0,0,0,1,1,1
727,408091,2,0,0,0,2,2,2
728,155073,0,0,0,200,200,200,200
729,154689,4,0,0,0,4,4,4
730,408178,1,0,0,0,1,1,1
731,408176,4,0,0,0,4,4,4
732,408173,2,0,0,0,2,2,2
733,408180,1,0,0,0,1,1,1
734,408181,1,0,0,0,1,1,1
735,408249,2,0,0,0,2,2,2
736,408230,1,0,0,0,1,1,1
737,408279,1,0,0,0,1,1,1
738,408272,13,0,0,0,13,13,13
739,408287,1,0,0,0,1,1,1
740,408289,1,0,0,0,1,1,1
741,154695,0,0,5,0,5,5,5
742,408307,1,0,0,0,1,1,1
743,408317,1,0,0,0,1,1,1
744,408319,1,0,0,0,1,1,1
745,408330,1,0,0,0,1,1,1
746,408327,1,0,0,0,1,1,1
747,408337,2,0,0,0,2,2,2
748,154700,0,0,0,3,3,3,3
749,154704,0,0,5,0,5,5,5
750,408403,1,0,0,0,1,1,1
751,408463,1,0,0,0,1,1,1
752,154706,0,0,0,3,3,3,3
753,154733,0,0,0,2,2,2,2
754,408477,1,0,0,0,1,1,1
755,408479,1,0,0,0,1,1,1
756,408481,3,0,0,0,3,3,3
757,408508,1,0,0,0,1,1,1
758,410621,1,0,0,0,1,1,1
759,410630,1,0,0,0,1,1,1
760,410254,2,0,0,0,2,2,2
761,410262,1,0,0,0,1,1,1
762,410267,2,0,0,0,2,2,2
763,410611,3,0,0,0,3,3,0
764,410667,1,0,0,0,1,1,1
765,410728,2,0,0,0,2,2,2
766,410678,5,0,0,0,5,5,5
767,410720,2,0,0,0,2,2,2
768,410756,1,0,0,0,1,1,0
769,410886,1,0,0,0,1,1,1
770,410891,2,0,0,0,2,2,2
771,410931,1,0,0,0,1,1,1
772,410975,1,0,0,0,1,1,1
773,410991,0,0,0,2,2,2,2
774,410994,4,0,0,0,4,4,4
775,411111,1,0,0,0,1,1,1
776,411133,2,0,0,0,2,2,2
777,411134,1,0,0,0,1,1,1
778,411202,2,0,0,0,2,2,2
779,414899,1,0,0,0,1,1,1
780,414903,1,0,0,0,1,1,1
781,414905,1,0,0,0,1,1,1
782,414907,1,0,0,0,1,1,1
783,414908,1,0,0,0,1,1,1
784,414909,1,0,0,0,1,1,1
785,414910,1,0,0,0,1,1,1
786,414911,1,0,0,0,1,1,1
787,414933,5,0,0,0,5,5,5
788,415323,1,0,0,0,1,1,1
789,414936,1,0,0,0,1,1,1
790,414937,1,0,0,0,1,1,1
791,414938,1,0,0,0,1,1,1
792,414940,1,0,0,0,1,1,1
793,414994,1,0,0,0,1,1,1
794,414995,1,0,0,0,1,1,1
795,414999,1,0,0,0,1,1,1
796,415001,1,0,0,0,1,1,1
797,415003,1,0,0,0,1,1,1
798,415021,6,0,0,0,6,6,6
799,415027,1,0,0,0,1,1,1
800,415029,1,0,0,0,1,1,1
801,415031,1,0,0,0,1,1,1
802,415033,1,0,0,0,1,1,1
803,415048,1,0,0,0,1,1,1
804,415049,1,0,0,0,1,1,1
805,415063,1,0,0,0,1,1,1
806,415064,1,0,0,0,1,1,1
807,415065,1,0,0,0,1,1,1
808,415105,1,0,0,0,1,1,1
809,415097,1,0,0,0,1,1,1
810,155061,0,0,24,0,24,24,24
811,415129,1,0,0,0,1,1,1
812,417410,1,0,0,0,1,1,1
813,415136,1,0,0,0,1,1,1
814,415137,1,0,0,0,1,1,1
815,415138,1,0,0,0,1,1,1
816,415139,2,0,0,0,2,2,2
817,415140,1,0,0,0,1,1,1
818,415154,1,0,0,0,1,1,1
819,155097,0,0,2,0,2,2,2
820,415161,1,0,0,0,1,1,1
821,415178,1,0,0,0,1,1,1
822,415176,1,0,0,0,1,1,1
823,415198,2,0,0,0,2,2,2
824,415200,1,0,0,0,1,1,1
825,415201,1,0,0,0,1,1,1
826,415202,2,0,0,0,2,2,2
827,415213,1,0,0,0,1,1,1
828,415214,1,0,0,0,1,1,1
829,415209,1,0,0,0,1,1,1
830,415204,1,0,0,0,1,1,1
831,415205,1,0,0,0,1,1,1
832,415220,1,0,0,0,1,1,1
833,415221,1,0,0,0,1,1,1
834,415223,1,0,0,0,1,1,1
835,415226,1,0,0,0,1,1,1
836,417648,1,0,0,0,1,1,1
837,415251,1,0,0,0,1,1,1
838,415328,1,0,0,0,1,1,1
839,415329,1,0,0,0,1,1,1
840,415330,1,0,0,0,1,1,1
841,415281,1,0,0,0,1,1,1
842,415284,1,0,0,0,1,1,1
843,415285,2,0,0,0,2,2,2
844,415286,1,0,0,0,1,1,1
845,415287,1,0,0,0,1,1,1
846,415288,1,0,0,0,1,1,1
847,415289,1,0,0,0,1,1,1
848,415291,1,0,0,0,1,1,1
849,429135,1,0,0,0,1,1,1
850,416752,1,0,0,0,1,1,1
851,415336,1,0,0,0,1,1,1
852,415337,4,0,0,0,4,4,4
853,415338,1,0,0,0,1,1,1
854,415339,1,0,0,0,1,1,1
855,415587,1,0,0,0,1,1,1
856,416741,1,0,0,0,1,1,1
857,416750,1,0,0,0,1,1,1
858,416761,1,0,0,0,1,1,1
859,416762,1,0,0,0,1,1,1
860,416763,1,0,0,0,1,1,1
861,416764,1,0,0,0,1,1,1
862,416767,2,0,0,0,2,2,2
863,416768,1,0,0,0,1,1,1
864,416772,1,0,0,0,1,1,1
865,416773,1,0,0,0,1,1,1
866,416774,1,0,0,0,1,1,1
867,416775,1,0,0,0,1,1,1
868,416797,1,0,0,0,1,1,1
869,416813,1,0,0,0,1,1,1
870,416816,1,0,0,0,1,1,1
871,417404,1,0,0,0,1,1,1
872,418374,1,0,0,0,1,1,1
873,417009,1,0,0,0,1,1,1
874,416999,2,0,0,0,2,2,2
875,417004,1,0,0,0,1,1,1
876,417005,1,0,0,0,1,1,1
877,417006,1,0,0,0,1,1,1
878,417007,1,0,0,0,1,1,1
879,417023,1,0,0,0,1,1,1
880,417029,1,0,0,0,1,1,1
881,417032,1,0,0,0,1,1,1
882,417034,1,0,0,0,1,1,1
883,417038,1,0,0,0,1,1,1
884,417039,1,0,0,0,1,1,1
885,417044,1,0,0,0,1,1,1
886,417045,1,0,0,0,1,1,1
887,417048,1,0,0,0,1,1,1
888,417049,1,0,0,0,1,1,1
889,417053,1,0,0,0,1,1,1
890,417070,1,0,0,0,1,1,1
891,417071,1,0,0,0,1,1,1
892,417072,1,0,0,0,1,1,1
893,417073,1,0,0,0,1,1,1
894,417074,1,0,0,0,1,1,1
895,417103,1,0,0,0,1,1,1
896,417104,1,0,0,0,1,1,1
897,417105,1,0,0,0,1,1,1
898,417108,1,0,0,0,1,1,1
899,417423,1,0,0,0,1,1,1
900,417164,1,0,0,0,1,1,1
901,417408,1,0,0,0,1,1,1
902,417148,1,0,0,0,1,1,1
903,417149,1,0,0,0,1,1,1
904,417150,1,0,0,0,1,1,1
905,417153,1,0,0,0,1,1,1
906,417154,1,0,0,0,1,1,1
907,417166,3,0,0,0,3,3,3
908,417224,1,0,0,0,1,1,1
909,417225,1,0,0,0,1,1,1
910,417226,5,0,0,0,5,5,5
911,417227,1,0,0,0,1,1,1
912,417228,1,0,0,0,1,1,1
913,417231,1,0,0,0,1,1,1
914,417233,1,0,0,0,1,1,1
915,417234,1,0,0,0,1,1,1
916,417235,1,0,0,0,1,1,1
917,417236,1,0,0,0,1,1,1
918,417237,1,0,0,0,1,1,1
919,417239,1,0,0,0,1,1,1
920,417240,1,0,0,0,1,1,1
921,417254,1,0,0,0,1,1,1
922,417255,1,0,0,0,1,1,1
923,417258,1,0,0,0,1,1,1
924,417259,1,0,0,0,1,1,1
925,417261,1,0,0,0,1,1,1
926,417262,1,0,0,0,1,1,1
927,417265,1,0,0,0,1,1,1
928,417266,3,0,0,0,3,3,3
929,417273,1,0,0,0,1,1,1
930,417277,1,0,0,0,1,1,1
931,417278,1,0,0,0,1,1,1
932,417280,1,0,0,0,1,1,1
933,417281,1,0,0,0,1,1,1
934,417309,1,0,0,0,1,1,1
935,417401,1,0,0,0,1,1,0
936,417402,1,0,0,0,1,1,1
937,417403,1,0,0,0,1,1,1
938,417405,1,0,0,0,1,1,1
939,417407,1,0,0,0,1,1,0
940,417412,1,0,0,0,1,1,1
941,417413,3,0,0,0,3,3,3
942,417419,1,0,0,0,1,1,0
943,417431,1,0,0,0,1,1,1
944,417520,1,0,0,0,1,1,1
945,417521,1,0,0,0,1,1,1
946,417519,2,0,0,0,2,2,2
947,417445,1,0,0,0,1,1,1
948,417447,1,0,0,0,1,1,1
949,417536,1,0,0,0,1,1,1
950,421059,1,0,0,0,1,1,1
951,420093,0,1,0,0,1,1,1
952,155269,0,0,3,0,3,3,3
953,155270,0,0,1,0,1,1,1
954,155272,0,0,1,0,1,1,1
955,417538,1,0,0,0,1,1,1
956,156948,0,0,0,312,312,312,312
957,155274,0,0,2,0,2,2,2
958,155275,0,0,10,0,10,10,10
959,155276,0,0,0,1,1,1,1
960,155277,0,0,0,1,1,1,1
961,155278,0,0,2,0,2,2,2
962,417540,1,0,0,0,1,1,1
963,417541,1,0,0,0,1,1,1
964,417542,1,0,0,0,1,1,1
965,417555,1,0,0,0,1,1,0
966,417545,1,0,0,0,1,1,1
967,417547,1,0,0,0,1,1,1
968,417551,1,0,0,0,1,1,1
969,417552,1,0,0,0,1,1,1
970,417570,1,0,0,0,1,1,1
971,417572,1,0,0,0,1,1,1
972,417581,1,0,0,0,1,1,1
973,417583,1,0,0,0,1,1,1
974,417629,1,0,0,0,1,1,1
975,417635,1,0,0,0,1,1,1
976,417592,2,0,0,0,2,2,2
977,417593,1,0,0,0,1,1,1
978,417632,1,0,0,0,1,1,1
979,417633,1,0,0,0,1,1,1
980,417630,1,0,0,0,1,1,1
981,417634,1,0,0,0,1,1,1
982,417636,1,0,0,0,1,1,1
983,417637,1,0,0,0,1,1,1
984,417638,1,0,0,0,1,1,1
985,417639,1,0,0,0,1,1,1
986,417649,1,0,0,0,1,1,1
987,417640,1,0,0,0,1,1,1
988,417641,1,0,0,0,1,1,1
989,417642,1,0,0,0,1,1,1
990,417643,1,0,0,0,1,1,1
991,155282,0,0,1,0,1,1,1
992,417650,2,0,0,0,2,2,2
993,417647,1,0,0,0,1,1,1
994,417651,1,0,0,0,1,1,1
995,417652,1,0,0,0,1,1,1
996,417654,7,0,0,0,7,7,7
997,417659,1,0,0,0,1,1,1
998,155284,0,11,0,0,11,11,11
999,155285,0,0,3,0,3,3,3
1000,417657,1,0,0,0,1,1,1
1001,417761,1,0,0,0,1,1,0
1002,417663,1,0,0,0,1,1,1
1003,417664,1,0,0,0,1,1,1
1004,155287,0,0,2,8,10,10,10
1005,155288,1,0,0,0,1,1,1
1006,155289,0,0,1,0,1,1,1
1007,155292,0,0,0,0,0,5,0
1008,155293,0,0,0,0,0,5,0
1009,417762,1,0,0,0,1,1,1
1010,417763,1,0,0,0,1,1,0
1011,417764,1,0,0,0,1,1,1
1012,417765,1,0,0,0,1,1,1
1013,417767,2,0,0,0,2,2,2
1014,417768,3,0,0,0,3,3,3
1015,417769,3,0,0,0,3,3,3
1016,417800,1,0,0,0,1,1,1
1017,417777,1,0,0,0,1,1,1
1018,417779,1,0,0,0,1,1,1
1019,155297,0,3,3,0,6,6,6
1020,417780,1,0,0,0,1,1,0
1021,417782,3,0,0,0,3,3,3
1022,417783,2,0,0,0,2,2,2
1023,417784,1,0,0,0,1,1,1
1024,417798,1,0,0,0,1,1,1
1025,417802,1,0,0,0,1,1,1
1026,417803,1,0,0,0,1,1,1
1027,417804,1,0,0,0,1,1,1
1028,417806,1,0,0,0,1,1,1
1029,155337,0,0,4,0,4,4,4
1030,155340,0,0,0,13,13,13,13
1031,155317,0,0,2,0,2,2,2
1032,155335,4,3,0,0,7,7,7
1033,155329,0,0,1,0,1,1,1
1034,155332,0,0,2,0,2,2,2
1035,417814,1,0,0,0,1,1,1
1036,417815,1,0,0,0,1,1,1
1037,417816,1,0,0,0,1,1,1
1038,155349,0,0,1,0,1,1,1
1039,155351,0,0,5,0,5,5,5
1040,155352,0,3,5,0,8,8,8
1041,155358,0,0,3,0,3,3,3
1042,417864,1,0,0,0,1,1,1
1043,417866,1,0,0,0,1,1,1
1044,417869,1,0,0,0,1,1,0
1045,155361,0,0,3,0,3,3,3
1046,155362,0,0,1,0,1,1,1
1047,155355,0,0,0,3,3,3,3
1048,417896,1,0,0,0,1,1,1
1049,417897,1,0,0,0,1,1,1
1050,417898,1,0,0,0,1,1,1
1051,417900,1,0,0,0,1,1,1
1052,417902,4,0,0,0,4,4,4
1053,155365,1,1,0,0,2,2,2
1054,155366,0,0,1,0,1,1,1
1055,155369,0,0,5,0,5,5,5
1056,417905,2,0,0,0,2,2,2
1057,417906,1,0,0,0,1,1,1
1058,417914,3,0,0,0,3,3,3
1059,417915,1,0,0,0,1,1,1
1060,417916,1,0,0,0,1,1,1
1061,417953,1,0,0,0,1,1,1
1062,417917,1,0,0,0,1,1,1
1063,417918,1,0,0,0,1,1,1
1064,417920,1,0,0,0,1,1,1
1065,417922,1,0,0,0,1,1,1
1066,417952,1,0,0,0,1,1,1
1067,155373,0,0,2,0,2,15,2
1068,155374,2,0,0,0,2,2,2
1069,155375,0,0,4,0,4,4,4
1070,417954,1,0,0,0,1,1,0
1071,417960,1,0,0,0,1,1,1
1072,417963,1,0,0,0,1,1,1
1073,417967,4,0,0,0,4,4,4
1074,417972,1,0,0,0,1,1,1
1075,417975,1,0,0,0,1,1,1
1076,418081,1,0,0,0,1,1,1
1077,418077,1,0,0,0,1,1,1
1078,418079,1,0,0,0,1,1,1
1079,418075,1,0,0,0,1,1,1
1080,418086,1,0,0,0,1,1,1
1081,418089,1,0,0,0,1,1,1
1082,155377,0,0,0,0,0,14,0
1083,418094,1,0,0,0,1,1,1
1084,418097,1,0,0,0,1,1,0
1085,418098,1,0,0,0,1,1,1
1086,155378,0,0,1,0,1,1,1
1087,418108,1,0,0,0,1,1,1
1088,418109,1,0,0,0,1,1,1
1089,418113,1,0,0,0,1,1,1
1090,418121,1,0,0,0,1,1,1
1091,155409,2,0,0,0,2,2,2
1092,418123,1,0,0,0,1,1,1
1093,418125,1,0,0,0,1,1,1
1094,418139,1,0,0,0,1,1,1
1095,418140,1,0,0,0,1,1,1
1096,418130,1,0,0,0,1,1,1
1097,418137,1,0,0,0,1,1,1
1098,418238,1,0,0,0,1,1,1
1099,418239,1,0,0,0,1,1,1
1100,418241,1,0,0,0,1,1,1
1101,418249,3,0,0,0,3,3,3
1102,418256,1,0,0,0,1,1,1
1103,418258,1,0,0,0,1,1,1
1104,418281,1,0,0,0,1,1,1
1105,155412,0,0,1,0,1,1,1
1106,155413,0,0,1,0,1,1,1
1107,155416,0,0,1,0,1,1,1
1108,156954,0,0,0,431,431,431,431
1109,418279,1,0,0,0,1,1,1
1110,418284,1,0,0,0,1,1,1
1111,418310,1,0,0,0,1,1,1
1112,418311,1,0,0,0,1,1,1
1113,418275,1,0,0,0,1,1,1
1114,418262,1,0,0,0,1,1,1
1115,418312,1,0,0,0,1,1,1
1116,418313,1,0,0,0,1,1,1
1117,418314,2,0,0,0,2,2,2
1118,418315,1,0,0,0,1,1,1
1119,418316,1,0,0,0,1,1,1
1120,418317,1,0,0,0,1,1,1
1121,418318,1,0,0,0,1,1,1
1122,155424,0,0,0,7,7,7,6
1123,155425,0,0,0,7,7,6,7
1124,155426,0,0,0,6,6,7,7
1125,155428,0,0,0,1,1,1,1
1126,418319,1,0,0,0,1,1,1
1127,418320,1,0,0,0,1,1,1
1128,418321,1,0,0,0,1,1,1
1129,418347,1,0,0,0,1,1,1
1130,155429,0,0,2,0,2,2,2
1131,418322,1,0,0,0,1,1,1
1132,418323,1,0,0,0,1,1,1
1133,418324,1,0,0,0,1,1,1
1134,418325,1,0,0,0,1,1,1
1135,418326,1,0,0,0,1,1,1
1136,418340,1,0,0,0,1,1,1
1137,418327,1,0,0,0,1,1,1
1138,418329,1,0,0,0,1,1,1
1139,418330,1,0,0,0,1,1,1
1140,418331,1,0,0,0,1,1,1
1141,418341,1,0,0,0,1,1,1
1142,418380,1,0,0,0,1,1,1
1143,418349,2,0,0,0,2,2,2
1144,418352,1,0,0,0,1,1,1
1145,418358,1,0,0,0,1,1,1
1146,418369,1,0,0,0,1,1,1
1147,418370,1,0,0,0,1,1,0
1148,418371,1,0,0,0,1,1,1
1149,418382,3,0,0,0,3,3,3
1150,418386,1,0,0,0,1,1,1
1151,418433,1,0,0,0,1,1,1
1152,418434,1,0,0,0,1,1,1
1153,418435,1,0,0,0,1,1,1
1154,418436,1,0,0,0,1,1,1
1155,155442,1,0,0,0,1,1,1
1156,155438,0,0,1,0,1,1,1
1157,155439,0,20,0,0,20,20,20
1158,155440,0,0,1,0,1,1,1
1159,418437,1,0,0,0,1,1,0
1160,418438,1,0,0,0,1,1,1
1161,418440,1,0,0,0,1,1,1
1162,418446,1,0,0,0,1,1,0
1163,418447,1,0,0,0,1,1,1
1164,418449,1,0,0,0,1,1,1
1165,418452,2,0,0,0,2,2,2
1166,418458,1,0,0,0,1,1,1
1167,156674,3,12,2,0,17,17,17
1168,156675,0,0,5,0,5,5,5
1169,418459,1,0,0,0,1,1,1
1170,418466,1,0,0,0,1,1,1
1171,418492,1,0,0,0,1,1,1
1172,418495,1,0,0,0,1,1,1
1173,418502,1,0,0,0,1,1,1
1174,418470,4,0,0,0,4,4,4
1175,418476,3,0,0,0,3,3,3
1176,418489,1,0,0,0,1,1,1
1177,418490,2,0,0,0,2,2,2
1178,156681,0,0,1,0,1,1,1
1179,418506,1,0,0,0,1,1,1
1180,418509,1,0,0,0,1,1,1
1181,418511,1,0,0,0,1,1,1
1182,418525,1,0,0,0,1,1,0
1183,418526,1,0,0,0,1,1,1
1184,418527,1,0,0,0,1,1,1
1185,418528,1,0,0,0,1,1,0
1186,418534,1,0,0,0,1,1,1
1187,418562,1,0,0,0,1,1,1
1188,418539,2,0,0,0,2,2,2
1189,156689,0,0,1,0,1,1,1
1190,156690,0,0,1,0,1,2,1
1191,418563,1,0,0,0,1,1,1
1192,418567,1,0,0,0,1,1,1
1193,418568,1,0,0,0,1,1,1
1194,418569,1,0,0,0,1,1,1
1195,418570,1,0,0,0,1,1,1
1196,418572,1,0,0,0,1,1,1
1197,418627,1,0,0,0,1,1,1
1198,418628,1,0,0,0,1,1,1
1199,418630,1,0,0,0,1,1,1
1200,418631,1,0,0,0,1,1,1
1201,418632,1,0,0,0,1,1,1
1202,418633,1,0,0,0,1,1,1
1203,418635,1,0,0,0,1,1,1
1204,418641,1,0,0,0,1,1,1
1205,418636,2,0,0,0,2,2,2
1206,156759,0,0,3,0,3,3,3
1207,156760,0,0,1,0,1,1,1
1208,156761,0,1,0,0,1,1,1
1209,156696,0,0,2,0,2,2,2
1210,418638,1,0,0,0,1,1,1
1211,418639,1,0,0,0,1,1,1
1212,418642,1,0,0,0,1,1,1
1213,418643,1,0,0,0,1,1,1
1214,418648,1,0,0,0,1,1,1
1215,156791,0,0,2,0,2,2,2
1216,156792,0,0,2,0,2,2,2
1217,156793,0,0,1,0,1,1,1
1218,418650,1,0,0,0,1,1,1
1219,418651,1,0,0,0,1,1,1
1220,418652,1,0,0,0,1,1,1
1221,418654,1,0,0,0,1,1,1
1222,418655,1,0,0,0,1,1,1
1223,418665,1,0,0,0,1,1,0
1224,418667,1,0,0,0,1,1,1
1225,418672,1,0,0,0,1,1,1
1226,418674,1,0,0,0,1,1,1
1227,418676,1,0,0,0,1,1,1
1228,418679,1,0,0,0,1,1,1
1229,418680,1,0,0,0,1,1,1
1230,418813,1,0,0,0,1,1,1
1231,418677,1,0,0,0,1,1,1
1232,156798,0,0,1,0,1,1,1
1233,156800,0,0,2,0,2,2,2
1234,156802,2,0,0,0,2,2,2
1235,418778,1,0,0,0,1,1,1
1236,418775,1,0,0,0,1,1,1
1237,418776,1,0,0,0,1,1,1
1238,418777,2,0,0,0,2,2,2
1239,156806,0,0,2,0,2,2,2
1240,418779,1,0,0,0,1,1,0
1241,418780,1,0,0,0,1,1,1
1242,418781,1,0,0,0,1,1,1
1243,418782,1,0,0,0,1,1,1
1244,418783,1,0,0,0,1,1,0
1245,418784,1,0,0,0,1,1,1
1246,418785,6,0,0,0,6,6,6
1247,156834,1,0,0,0,1,1,1
1248,156835,0,0,1,0,1,1,1
1249,418786,1,0,0,0,1,1,1
1250,418787,1,0,0,0,1,1,1
1251,418793,1,0,0,0,1,1,0
1252,418795,6,0,0,0,6,6,6
1253,156955,0,0,0,117,117,117,117
1254,418799,1,0,0,0,1,1,1
1255,418800,1,0,0,0,1,1,1
1256,418810,2,0,0,0,2,2,2
1257,418814,1,0,0,0,1,1,1
1258,418815,1,0,0,0,1,1,1
1259,418817,1,0,0,0,1,1,1
1260,418818,1,0,0,0,1,1,1
1261,418822,1,0,0,0,1,1,0
1262,418823,1,0,0,0,1,1,1
1263,156845,1,0,0,0,1,1,1
1264,418826,1,0,0,0,1,1,1
1265,418827,1,0,0,0,1,1,0
1266,418884,2,0,0,0,2,2,2
1267,418885,1,0,0,0,1,1,1
1268,418886,1,0,0,0,1,1,0
1269,418887,1,0,0,0,1,1,1
1270,418888,1,0,0,0,1,1,0
1271,418889,1,0,0,0,1,1,1
1272,418890,1,0,0,0,1,1,1
1273,418891,3,0,0,0,3,3,3
1274,418892,1,0,0,0,1,1,0
1275,418893,1,0,0,0,1,1,1
1276,418894,2,0,0,0,2,2,2
1277,419853,1,0,0,0,1,1,1
1278,418902,1,0,0,0,1,1,1
1279,418904,1,0,0,0,1,1,1
1280,418906,1,0,0,0,1,1,1
1281,418910,3,0,0,0,3,3,3
1282,418915,1,0,0,0,1,1,0
1283,418916,1,0,0,0,1,1,0
1284,156851,3,0,0,0,3,3,3
1285,418912,1,0,0,0,1,1,1
1286,419854,1,0,0,0,1,1,0
1287,419852,1,0,0,0,1,1,1
1288,198673,0,0,1,0,1,1,1
1289,203643,4,0,0,0,4,15,4
1290,419857,1,0,0,0,1,1,1
1291,419860,1,0,0,0,1,1,1
1292,420088,1,0,0,0,1,1,0
1293,419885,1,0,0,0,1,1,1
1294,419887,1,0,0,0,1,1,0
1295,419890,2,0,0,0,2,2,2
1296,420089,2,0,0,0,2,2,2
1297,420094,1,0,0,0,1,1,1
1298,198680,4,0,4,0,8,8,8
1299,421239,1,0,0,0,1,1,1
1300,420109,1,0,0,0,1,1,1
1301,420111,1,0,0,0,1,1,1
1302,420114,1,0,0,0,1,1,1
1303,420117,1,0,0,0,1,1,1
1304,420582,1,0,0,0,1,1,1
1305,420649,1,0,0,0,1,1,1
1306,198693,0,0,12,0,12,12,12
1307,198695,0,0,2,0,2,2,2
1308,198696,0,0,1,0,1,1,1
1309,198895,0,0,0,171,171,171,171
1310,203423,0,0,0,177,177,177,177
1311,198701,2,0,0,0,2,2,2
1312,420129,1,0,0,0,1,1,1
1313,198826,0,0,4,0,4,4,4
1314,198828,0,4,0,0,4,4,4
1315,198829,0,0,1,0,1,1,1
1316,198830,0,1,0,0,1,1,1
1317,198832,0,2,0,0,2,3,2
1318,198833,0,0,2,0,2,2,2
1319,420583,1,0,0,0,1,1,1
1320,420584,1,0,0,0,1,1,1
1321,420586,1,0,0,0,1,1,1
1322,420587,4,0,0,0,4,4,4
1323,420590,1,0,0,0,1,1,1
1324,420599,1,0,0,0,1,1,0
1325,420591,2,0,0,0,2,2,2
1326,420595,1,0,0,0,1,1,1
1327,420597,2,0,0,0,2,2,2
1328,420589,2,0,0,0,2,2,2
1329,198834,0,0,1,0,1,1,1
1330,198844,0,0,5,0,5,5,5
1331,198839,0,0,2,0,2,2,2
1332,420600,1,0,0,0,1,1,1
1333,420601,3,0,0,0,3,3,3
1334,420604,1,0,0,0,1,1,1
1335,420607,1,0,0,0,1,1,1
1336,420611,1,0,0,0,1,1,1
1337,420650,1,0,0,0,1,1,1
1338,420641,1,0,0,0,1,1,0
1339,420643,1,0,0,0,1,1,0
1340,420616,1,0,0,0,1,1,1
1341,420617,1,0,0,0,1,1,1
1342,420635,1,0,0,0,1,1,1
1343,420903,1,0,0,0,1,1,1
1344,420890,1,0,0,0,1,1,1
1345,198859,0,0,2,0,2,2,2
1346,198860,0,0,5,0,5,5,5
1347,420636,1,0,0,0,1,1,1
1348,420660,1,0,0,0,1,1,1
1349,420662,1,0,0,0,1,1,1
1350,420666,5,0,0,0,5,5,5
1351,420669,1,0,0,0,1,1,1
1352,420670,1,0,0,0,1,1,1
1353,420680,1,0,0,0,1,1,1
1354,420682,1,0,0,0,1,1,1
1355,420684,1,0,0,0,1,1,1
1356,420685,1,0,0,0,1,1,1
1357,420687,1,0,0,0,1,1,1
1358,420688,1,0,0,0,1,1,1
1359,420704,1,0,0,0,1,1,1
1360,420705,1,0,0,0,1,1,1
1361,420710,1,0,0,0,1,1,1
1362,420711,1,0,0,0,1,1,1
1363,420713,1,0,0,0,1,1,1
1364,420714,1,0,0,0,1,1,1
1365,420715,1,0,0,0,1,1,1
1366,420723,1,0,0,0,1,1,1
1367,420767,1,0,0,0,1,1,1
1368,420769,1,0,0,0,1,1,1
1369,420773,1,0,0,0,1,1,1
1370,420774,1,0,0,0,1,1,1
1371,420781,1,0,0,0,1,1,1
1372,420782,1,0,0,0,1,1,1
1373,420790,1,0,0,0,1,1,1
1374,420791,1,0,0,0,1,1,1
1375,420797,1,0,0,0,1,1,1
1376,420807,1,0,0,0,1,1,1
1377,420808,1,0,0,0,1,1,1
1378,420811,1,0,0,0,1,1,1
1379,420814,1,0,0,0,1,1,1
1380,420825,1,0,0,0,1,1,1
1381,420826,1,0,0,0,1,1,1
1382,420832,1,0,0,0,1,1,1
1383,420834,1,0,0,0,1,1,1
1384,420845,1,0,0,0,1,1,1
1385,420848,1,0,0,0,1,1,1
1386,420868,1,0,0,0,1,1,1
1387,420870,1,0,0,0,1,1,1
1388,198887,0,0,10,0,10,10,10
1389,198890,0,0,0,8,8,8,8
1390,420891,3,0,0,0,3,3,3
1391,420902,1,0,0,0,1,1,0
1392,420873,1,0,0,0,1,1,1
1393,420874,1,0,0,0,1,1,1
1394,420918,1,0,0,0,1,1,1
1395,420919,1,0,0,0,1,1,1
1396,420921,1,0,0,0,1,1,1
1397,420988,1,0,0,0,1,1,1
1398,420989,1,0,0,0,1,1,1
1399,420990,1,0,0,0,1,1,1
1400,420991,1,0,0,0,1,1,1
1401,420995,1,0,0,0,1,1,1
1402,420997,1,0,0,0,1,1,1
1403,421016,1,0,0,0,1,1,1
1404,421017,1,0,0,0,1,1,1
1405,421018,1,0,0,0,1,1,1
1406,421019,1,0,0,0,1,1,0
1407,421020,1,0,0,0,1,1,0
1408,421021,1,0,0,0,1,1,0
1409,421032,4,0,0,0,4,4,4
1410,421036,2,0,0,0,2,2,2
1411,421198,1,0,0,0,1,1,1
1412,198869,0,0,13,0,13,13,13
1413,198899,0,0,0,0,0,4,0
1414,421053,1,0,0,0,1,1,1
1415,421054,1,0,0,0,1,1,1
1416,421055,1,0,0,0,1,1,1
1417,421056,1,0,0,0,1,1,1
1418,421057,1,0,0,0,1,1,1
1419,421058,1,0,0,0,1,1,1
1420,421060,1,0,0,0,1,1,1
1421,421061,1,0,0,0,1,1,1
1422,421062,1,0,0,0,1,1,1
1423,421063,1,0,0,0,1,1,1
1424,421064,1,0,0,0,1,1,1
1425,198904,0,0,30,0,30,30,30
1426,198915,0,0,2,0,2,2,2
1427,198917,0,0,1,0,1,1,1
1428,421067,1,0,0,0,1,1,1
1429,421069,1,0,0,0,1,1,1
1430,421070,2,0,0,0,2,2,2
1431,421071,3,0,0,0,3,3,3
1432,421170,1,0,0,0,1,1,1
1433,421176,7,0,0,0,7,7,7
1434,421189,1,0,0,0,1,1,1
1435,421190,2,0,0,0,2,2,2
1436,421196,1,0,0,0,1,1,1
1437,421201,1,0,0,0,1,1,1
1438,421202,2,0,0,0,2,2,2
1439,421206,5,0,0,0,5,5,5
1440,421231,1,0,0,0,1,1,1
1441,421232,1,0,0,0,1,1,1
1442,421233,1,0,0,0,1,1,1
1443,421234,1,0,0,0,1,1,1
1444,421241,1,0,0,0,1,1,1
1445,421250,1,0,0,0,1,1,1
1446,421439,1,0,0,0,1,1,1
1447,198925,0,0,1,0,1,1,1
1448,198947,0,0,0,0,0,13,0
1449,198948,0,0,0,0,0,2,0
1450,198949,0,0,0,0,0,1,0
1451,198945,3,0,0,0,3,3,3
1452,421251,1,0,0,0,1,1,1
1453,421256,1,0,0,0,1,1,1
1454,421257,1,0,0,0,1,1,1
1455,421260,1,0,0,0,1,1,1
1456,421262,1,0,0,0,1,1,1
1457,421294,1,0,0,0,1,1,1
1458,421295,2,0,0,0,2,2,2
1459,421302,1,0,0,0,1,1,1
1460,421306,1,0,0,0,1,1,1
1461,421581,1,0,0,0,1,1,1
1462,423737,1,0,0,0,1,1,1
1463,421308,2,0,0,0,2,2,2
1464,421318,3,0,0,0,3,3,3
1465,421322,3,0,0,0,3,3,3
1466,421435,1,0,0,0,1,1,1
1467,421436,1,0,0,0,1,1,1
1468,428285,1,0,0,0,1,1,1
1469,422609,1,0,0,0,1,1,1
1470,198953,0,0,3,0,3,3,3
1471,198955,0,7,0,0,7,7,7
1472,198958,0,12,0,0,12,12,12
1473,198960,0,0,6,0,6,7,6
1474,421440,1,0,0,0,1,1,1
1475,421455,1,0,0,0,1,1,1
1476,421463,1,0,0,0,1,1,1
1477,421465,1,0,0,0,1,1,1
1478,421453,1,0,0,0,1,1,1
1479,421513,1,0,0,0,1,1,1
1480,421519,4,0,0,0,4,4,4
1481,421582,2,0,0,0,2,2,2
1482,421599,1,0,0,0,1,1,1
1483,421601,1,0,0,0,1,1,1
1484,421608,1,0,0,0,1,1,1
1485,421614,1,0,0,0,1,1,1
1486,421618,1,0,0,0,1,1,1
1487,421620,1,0,0,0,1,1,1
1488,421623,1,0,0,0,1,1,1
1489,422210,3,0,0,0,3,3,3
1490,422253,3,0,0,0,3,3,3
1491,422260,1,0,0,0,1,1,1
1492,422277,1,0,0,0,1,1,1
1493,422280,3,0,0,0,3,3,3
1494,422282,4,0,0,0,4,4,4
1495,422418,2,0,0,0,2,2,2
1496,422428,1,0,0,0,1,1,1
1497,422429,1,0,0,0,1,1,1
1498,422430,1,0,0,0,1,1,1
1499,422330,1,0,0,0,1,1,1
1500,422321,2,0,0,0,2,2,2
1501,422361,3,0,0,0,3,3,3
1502,422566,3,0,0,0,3,3,3
1503,422436,1,0,0,0,1,1,1
1504,422437,1,0,0,0,1,1,1
1505,422443,1,0,0,0,1,1,1
1506,422449,1,0,0,0,1,1,1
1507,422450,2,0,0,0,2,2,2
1508,198962,2,0,2,0,4,4,4
1509,198964,0,0,7,0,7,7,7
1510,198965,0,0,1,0,1,1,1
1511,198966,0,0,3,0,3,3,3
1512,198967,2,0,0,0,2,2,2
1513,422602,1,0,0,0,1,1,1
1514,422603,1,0,0,0,1,1,1
1515,422683,4,0,0,0,4,4,4
1516,422701,1,0,0,0,1,1,0
1517,422705,1,0,0,0,1,1,1
1518,422706,1,0,0,0,1,1,1
1519,423734,1,0,0,0,1,1,1
1520,423736,2,0,0,0,2,2,2
1521,203337,0,0,8,0,8,8,8
1522,203335,0,0,4,0,4,4,4
1523,203343,0,0,8,0,8,8,8
1524,424117,1,0,0,0,1,1,1
1525,423790,1,0,0,0,1,1,1
1526,423791,1,0,0,0,1,1,1
1527,423794,1,0,0,0,1,1,1
1528,423799,2,0,0,0,2,2,2
1529,423803,1,0,0,0,1,1,1
1530,423806,1,0,0,0,1,1,1
1531,423817,1,0,0,0,1,1,1
1532,423819,1,0,0,0,1,1,1
1533,423820,4,0,0,0,4,4,4
1534,423823,1,0,0,0,1,1,1
1535,423824,1,0,0,0,1,1,1
1536,423836,1,0,0,0,1,1,1
1537,423840,1,0,0,0,1,1,1
1538,423843,1,0,0,0,1,1,1
1539,423847,4,0,0,0,4,4,4
1540,423881,1,0,0,0,1,1,1
1541,423882,1,0,0,0,1,1,1
1542,423883,1,0,0,0,1,1,1
1543,203356,0,0,2,0,2,2,2
1544,203354,0,0,1,0,1,1,1
1545,423884,2,0,0,0,2,2,2
1546,423885,5,0,0,0,5,5,5
1547,423886,1,0,0,0,1,1,1
1548,423898,1,0,0,0,1,1,1
1549,423899,1,0,0,0,1,1,1
1550,423900,1,0,0,0,1,1,1
1551,423919,1,0,0,0,1,1,0
1552,423928,1,0,0,0,1,1,1
1553,423935,2,0,0,0,2,2,2
1554,423951,2,0,0,0,2,2,2
1555,423955,1,0,0,0,1,1,1
1556,424832,1,0,0,0,1,1,1
1557,203368,0,0,3,0,3,3,3
1558,203365,0,0,4,0,4,4,4
1559,423956,3,0,0,0,3,3,3
1560,424029,1,0,0,0,1,1,1
1561,424030,1,0,0,0,1,1,1
1562,423991,18,0,0,0,18,18,18
1563,424006,4,0,0,0,4,4,4
1564,424023,4,0,0,0,4,4,4
1565,424027,2,0,0,0,2,2,2
1566,423952,1,0,0,0,1,1,1
1567,424032,1,0,0,0,1,1,1
1568,424033,1,0,0,0,1,1,1
1569,424034,9,0,0,0,9,9,9
1570,424070,5,0,0,0,5,5,5
1571,424071,1,0,0,0,1,1,1
1572,424031,2,0,0,0,2,2,2
1573,203377,0,0,16,0,16,16,16
1574,203393,0,7,0,0,7,7,7
1575,203391,0,0,11,0,11,11,11
1576,203392,5,0,0,0,5,5,5
1577,424089,1,0,0,0,1,1,1
1578,424091,1,0,0,0,1,1,1
1579,424104,1,0,0,0,1,1,1
1580,424106,1,0,0,0,1,1,1
1581,424119,1,0,0,0,1,1,1
1582,424123,1,0,0,0,1,1,1
1583,424170,2,0,0,0,2,2,2
1584,424171,3,0,0,0,3,3,3
1585,424172,1,0,0,0,1,1,1
1586,424175,11,0,0,0,11,11,11
1587,424176,3,0,0,0,3,3,3
1588,424180,1,0,0,0,1,1,1
1589,203395,0,0,2,0,2,2,2
1590,203396,0,0,3,0,3,3,3
1591,203397,0,0,2,0,2,2,2
1592,203398,0,0,3,0,3,3,3
1593,424185,8,0,0,0,8,8,8
1594,424200,2,0,0,0,2,2,2
1595,424201,2,0,0,0,2,2,2
1596,424204,1,0,0,0,1,1,1
1597,424205,1,0,0,0,1,1,1
1598,425984,1,0,0,0,1,1,1
1599,424217,1,0,0,0,1,1,1
1600,424218,2,0,0,0,2,2,2
1601,424240,2,0,0,0,2,2,2
1602,424241,2,0,0,0,2,2,2
1603,424244,1,0,0,0,1,1,1
1604,424245,1,0,0,0,1,1,1
1605,424248,3,0,0,0,3,3,3
1606,203399,0,0,2,0,2,2,2
1607,203402,0,4,0,0,4,4,4
1608,203403,0,2,0,0,2,2,2
1609,203401,0,0,2,0,2,2,2
1610,424251,5,0,0,0,5,5,5
1611,424253,1,0,0,0,1,1,0
1612,424254,3,0,0,0,3,3,3
1613,424259,8,0,0,0,8,8,8
1614,424296,2,0,0,0,2,2,2
1615,424297,5,0,0,0,5,5,5
1616,424298,3,0,0,0,3,3,3
1617,424300,1,0,0,0,1,1,1
1618,424302,1,0,0,0,1,1,1
1619,424303,1,0,0,0,1,1,1
1620,424831,1,0,0,0,1,1,1
1621,424319,1,0,0,0,1,1,1
1622,424320,1,0,0,0,1,1,1
1623,424322,10,0,0,0,10,10,10
1624,424333,3,0,0,0,3,3,3
1625,424335,5,0,0,0,5,5,5
1626,424350,1,0,0,0,1,1,1
1627,424351,1,0,0,0,1,1,1
1628,424403,2,0,0,0,2,2,2
1629,424405,2,0,0,0,2,2,2
1630,424830,1,0,0,0,1,1,1
1631,425987,1,0,0,0,1,1,1
1632,424833,1,0,0,0,1,1,1
1633,425964,1,0,0,0,1,1,1
1634,203407,0,0,1,0,1,1,1
1635,425966,1,0,0,0,1,1,1
1636,425969,1,0,0,0,1,1,1
1637,425973,1,0,0,0,1,1,1
1638,425990,1,0,0,0,1,1,1
1639,425995,2,0,0,0,2,2,2
1640,425996,1,0,0,0,1,1,1
1641,425997,1,0,0,0,1,1,1
1642,426039,1,0,0,0,1,1,1
1643,426040,1,0,0,0,1,1,0
1644,203413,3,0,0,0,3,3,3
1645,426041,1,0,0,0,1,1,1
1646,426043,1,0,1,0,2,2,2
1647,203415,0,0,1,1,2,2,2
1648,428093,1,0,0,0,1,1,0
1649,428094,2,0,0,0,2,2,2
1650,428096,1,0,0,0,1,1,1
1651,428158,1,0,0,0,1,1,1
1652,428161,1,0,0,0,1,1,1
1653,428176,1,0,0,0,1,1,1
1654,428177,1,0,0,0,1,1,1
1655,428178,1,0,0,0,1,1,1
1656,428180,1,0,0,0,1,1,1
1657,428181,1,0,0,0,1,1,0
1658,428182,1,0,0,0,1,1,1
1659,428185,1,0,0,0,1,1,1
1660,203514,0,0,1,0,1,1,1
1661,203507,0,2,0,0,2,2,2
1662,428189,1,0,0,0,1,1,1
1663,428447,1,0,0,0,1,1,1
1664,428202,1,0,0,0,1,1,1
1665,428272,2,0,0,0,2,2,2
1666,203523,0,0,1,0,1,1,1
1667,203524,0,3,0,0,3,3,3
1668,203526,0,0,1,0,1,1,1
1669,203619,0,0,3,0,3,3,3
1670,428291,2,0,0,0,2,2,2
1671,203616,0,0,1,0,1,1,1
1672,203611,0,2,0,0,2,2,2
1673,203612,0,0,1,0,1,1,1
1674,428301,1,0,0,0,1,1,1
1675,428903,1,0,0,0,1,1,1
1676,428299,1,0,0,0,1,1,0
1677,428300,1,0,0,0,1,1,0
1678,203627,0,0,1,0,1,1,1
1679,428302,1,0,0,0,1,1,1
1680,428309,1,0,0,0,1,1,0
1681,428448,1,0,0,0,1,1,0
1682,428668,1,0,0,0,1,1,1
1683,428673,1,0,0,0,1,1,1
1684,428674,1,0,0,0,1,1,0
1685,428677,1,0,0,0,1,1,1
1686,428772,1,0,0,0,1,1,1
1687,428773,1,0,0,0,1,1,1
1688,428774,1,0,0,0,1,1,0
1689,428779,1,0,0,0,1,1,1
1690,428780,1,0,0,0,1,1,1
1691,203661,0,0,0,0,0,1,0
1692,428783,1,0,0,0,1,1,1
1693,428785,1,0,0,0,1,1,1
1694,428818,1,0,0,0,1,1,0
1695,428820,1,0,0,0,1,1,1
1696,428822,1,0,0,0,1,1,1
1697,428897,1,0,0,0,1,1,1
1698,428898,1,0,0,0,1,1,1
1699,203665,0,1,0,0,1,1,1
1700,428904,1,0,0,0,1,1,0
1701,428931,1,0,0,0,1,1,1
1702,428932,1,0,0,0,1,1,1
1703,203669,1,0,0,0,1,1,1
1704,203670,1,0,0,0,1,1,1
1705,203671,0,1,0,0,1,1,1
1706,203672,0,0,1,0,1,1,1
1707,203673,0,0,1,0,1,1,1
1708,428974,1,0,0,0,1,1,1
1709,203677,1,0,0,0,1,1,1
1710,203678,0,0,1,0,1,1,1
1711,203679,0,1,0,0,1,1,1
1712,203681,0,1,0,0,1,1,1
1713,429029,1,0,0,0,1,1,1
1714,429031,1,0,0,0,1,1,1
1715,429036,1,0,0,0,1,1,1
1716,429102,1,0,0,0,1,1,1
1717,203682,1,0,0,0,1,1,1
1718,429039,1,0,0,0,1,1,1
1719,429103,1,0,0,0,1,1,1
1720,429126,1,0,0,0,1,1,0
1721,429127,1,0,0,0,1,1,0
1722,429138,1,0,0,0,1,1,1
1723,429132,2,0,0,0,2,2,2
1724,429133,1,0,0,0,1,1,1
1725,429149,1,0,0,0,1,1,1
1726,429137,1,0,0,0,1,1,0
1727,429136,1,0,0,0,1,1,0
1728,429139,1,0,0,0,1,1,1
1729,429147,1,0,0,0,1,1,1
1730,429148,1,0,0,0,1,1,0
1731,429151,1,0,0,0,1,1,1
1732,429159,1,0,0,0,1,1,1
1733,204566,0,0,1,0,1,1,1
1734,429174,1,0,0,0,1,1,1
1735,429175,1,0,0,0,1,1,1
1736,429177,1,0,0,0,1,1,0
1737,204572,0,0,0,0,0,7,0
1738,204582,0,1,0,0,1,1,1
1739,204585,0,4,0,0,4,4,4
1740,204587,0,0,1,0,1,1,1
1741,204590,0,0,3,0,3,3,3
1742,204594,1,0,0,0,1,1,1
1743,204595,0,2,3,0,5,5,5
1744,429180,1,0,0,0,1,1,0
1745,429182,1,0,0,0,1,1,1
1746,429184,1,0,0,0,1,1,0
1747,429187,1,0,0,0,1,1,1
1748,429194,1,0,0,0,1,1,1
1749,429196,1,0,0,0,1,1,0
1750,204597,2,0,0,0,2,2,2
1751,204598,1,0,0,0,1,1,1
1752,204599,0,0,2,0,2,2,2
1753,429209,1,0,0,0,1,1,1
1754,429213,1,0,0,0,1,1,0
1755,429206,2,0,0,0,2,2,2
1756,204601,0,0,1,0,1,1,1
1757,204602,1,0,0,0,1,1,1
1758,429274,1,0,0,0,1,1,1
1759,429283,1,0,0,0,1,1,1
1760,429285,2,0,0,0,2,2,0
1761,204605,0,0,2,0,2,2,2
1762,204712,0,19,0,0,19,19,19
1763,204698,0,0,1,0,1,1,1
1764,429294,1,0,0,0,1,1,0
1765,429311,1,0,0,0,1,1,1
1766,429297,1,0,0,0,1,1,0
1767,395636,0,1,0,0,1,1,1
1768,407004,5,0,0,0,5,5,5
1769,422339,1,0,0,0,1,1,1
1770,429306,1,0,0,0,1,1,0
1771,211797,0,0,25,0,25,25,25
1772,204788,0,0,3,0,3,3,3
1773,429313,1,0,0,0,1,1,0
1774,429315,1,0,0,0,1,1,0
1775,429351,1,0,0,0,1,1,0
1776,429356,1,0,0,0,1,1,0
1777,429372,1,0,0,0,1,1,1
1778,429373,1,0,0,0,1,1,1
1779,204798,0,0,1,0,1,1,1
1780,204800,0,0,1,0,1,1,1
1781,204801,0,0,1,0,1,1,1
1782,429582,2,0,0,0,2,2,2
1783,429598,2,0,0,0,2,2,2
1784,429625,1,0,0,0,1,1,1
1785,429592,1,0,0,0,1,1,1
1786,204802,0,0,2,0,2,2,2
1787,204803,0,0,1,0,1,1,1
1788,429608,1,0,0,0,1,1,1
1789,429609,1,0,0,0,1,1,0
1790,429613,1,0,0,0,1,1,0
1791,429615,1,0,0,0,1,1,1
1792,429619,2,0,0,0,2,2,0
1793,429622,1,0,0,0,1,1,0
1794,429629,1,0,0,0,1,1,0
1795,429739,1,0,0,0,1,1,0
1796,429685,1,0,0,0,1,1,0
1797,429701,1,0,0,0,1,1,1
1798,429704,1,0,0,0,1,1,1
1799,429763,1,0,0,0,1,1,1
1800,429735,1,0,0,0,1,1,1
1801,429738,1,0,0,0,1,1,1
1802,204927,0,1,1,0,2,2,2
1803,204932,0,2,1,0,3,3,3
1804,429758,1,0,0,0,1,1,0
1805,392740,0,0,2,0,2,2,2
1806,429818,1,0,0,0,1,1,0
1807,429820,1,0,0,0,1,1,1
1808,429826,1,0,0,0,1,1,1
1809,204938,0,0,1,0,1,1,1
1810,204940,0,0,1,0,1,1,1
1811,429829,1,0,0,0,1,1,1
1812,392756,0,0,2,0,2,2,2
1813,392763,0,0,1,0,1,1,0
1814,204942,0,0,1,0,1,1,1
1815,429845,1,0,0,0,1,1,1
1816,429847,1,0,0,0,1,1,1
1817,429849,1,0,0,0,1,1,0
1818,429852,1,0,0,0,1,1,0
1819,429850,2,0,0,0,2,2,2
1820,429906,1,0,0,0,1,1,1
1821,429929,1,0,0,0,1,1,1
1822,429891,1,0,0,0,1,1,0
1823,429892,1,0,0,0,1,1,1
1824,429893,1,0,0,0,1,1,1
1825,204950,0,0,1,0,1,1,1
1826,204951,0,0,1,0,1,1,1
1827,429894,1,0,0,0,1,1,1
1828,429895,1,0,0,0,1,1,1
1829,429900,1,0,0,0,1,1,0
1830,204954,0,0,2,0,2,2,2
1831,429916,2,0,0,0,2,2,2
1832,429932,1,0,0,0,1,1,1
1833,429923,1,0,0,0,1,1,1
1834,429928,1,0,0,0,1,1,0
1835,429942,1,0,0,0,1,1,1
1836,429943,1,0,0,0,1,1,1
1837,204960,0,1,0,0,1,1,1
1838,429992,1,0,0,0,1,1,1
1839,429993,1,0,0,0,1,1,1
1840,429995,1,0,0,0,1,1,1
1841,204961,0,0,2,0,2,2,2
1842,433253,2,0,0,0,2,2,2
1843,433254,1,0,0,0,1,1,1
1844,433264,1,0,0,0,1,1,1
1845,433267,1,0,0,0,1,1,1
1846,433268,1,0,0,0,1,1,0
1847,204968,0,0,1,0,1,1,1
1848,433270,1,0,0,0,1,1,0
1849,433271,4,0,0,0,4,4,4
1850,204971,1,0,0,0,1,1,1
1851,433272,1,0,0,0,1,1,1
1852,433273,1,0,0,0,1,1,1
1853,204972,1,0,0,0,1,1,1
1854,204973,0,0,1,0,1,1,1
1855,204974,0,0,3,0,3,3,3
1856,211716,0,0,0,0,0,11,0
1857,205044,0,0,2,0,2,2,2
1858,205045,0,0,3,0,3,3,3
1859,205047,2,0,1,0,3,3,3
1860,211942,0,0,16,0,16,16,16
1861,205049,0,0,2,0,2,2,2
1862,205051,1,0,0,0,1,1,1
1863,211789,4,0,1,0,5,5,5
1864,211791,8,0,0,0,8,9,8
1865,211792,0,1,2,0,3,3,3
1866,211800,1,0,0,0,1,1,1
1867,211801,1,0,0,0,1,1,1
1868,211804,1,0,0,0,1,1,1
1869,211918,0,0,0,1,1,1,1
1870,211921,1,0,0,0,1,1,1
1871,211924,0,1,0,0,1,1,1
1872,211925,1,0,0,0,1,1,1
1873,211926,0,1,0,0,1,1,1
1874,211927,0,2,0,0,2,2,2
1875,211930,1,0,0,0,1,1,1
1876,211931,1,0,0,0,1,1,1
1877,211932,0,0,2,0,2,2,2
1878,211934,3,0,0,0,3,3,3
1879,211935,1,0,0,0,1,1,1
1880,211940,0,0,1,0,1,1,1
1881,211941,1,0,0,0,1,1,1
1882,211949,1,0,2,0,3,3,3
1883,218220,0,1,0,0,1,1,1
1884,218221,0,1,0,0,1,1,1
1885,218222,1,0,0,0,1,1,1
1886,218219,2,0,0,0,2,2,2
1887,218224,0,1,1,0,2,2,2
1888,218226,1,0,0,0,1,1,1
1889,218227,1,0,0,0,1,1,1
1890,218228,0,0,1,0,1,1,1
1891,218232,0,0,3,0,3,3,3
1892,218229,0,0,1,0,1,1,1
1893,218231,1,0,0,0,1,1,1
1894,218233,0,0,4,0,4,4,4
1895,218235,3,0,0,0,3,3,3
1896,218642,0,6,0,0,6,8,0
1897,218638,1,0,0,0,1,1,1
1898,218639,0,3,0,0,3,3,3
1899,218641,1,0,0,0,1,1,1
1900,218645,2,0,0,0,2,2,2
1901,218647,1,0,0,0,1,1,1
1902,218648,1,0,0,0,1,1,1
1903,218649,0,0,0,0,0,3,0
1904,218719,0,10,0,0,10,10,10
1905,218720,2,0,0,0,2,2,2
1906,218724,0,7,0,0,7,7,7
1907,218723,0,2,0,0,2,2,2
1908,218725,0,1,0,0,1,1,1
1909,218726,0,3,0,0,3,3,3
1910,218728,0,2,0,0,2,2,2
1911,218730,0,1,0,0,1,1,1
1912,218734,3,0,0,0,3,3,3
1913,218750,2,0,0,0,2,1,2
1914,218755,0,7,0,0,7,7,7
1915,218752,0,0,4,0,4,4,4
1916,218758,1,0,0,0,1,1,1
1917,218759,1,0,0,0,1,1,1
1918,218764,0,2,0,0,2,2,2
1919,218765,0,1,0,0,1,1,1
1920,225853,1,0,0,0,1,1,1
1921,225859,1,0,0,0,1,1,1
1922,225861,0,0,1,0,1,1,1
1923,225863,1,0,0,0,1,1,1
1924,225868,0,2,0,0,2,2,2
1925,236746,3,0,0,0,3,4,3
1926,225866,0,2,0,0,2,2,2
1927,225871,3,1,0,0,4,11,4
1928,225872,2,1,0,0,3,4,3
1929,225874,2,0,0,0,2,1,2
1930,225875,1,0,0,0,1,2,1
1931,225876,0,8,0,0,8,8,8
1932,232238,0,1,0,0,1,1,1
1933,232239,0,1,0,0,1,1,1
1934,232243,0,0,1,0,1,1,1
1935,232244,0,2,0,0,2,2,2
1936,429358,1,0,0,0,1,1,0
1937,232417,0,1,0,0,1,1,1
1938,232418,1,0,0,0,1,1,1
1939,232419,2,0,0,0,2,2,2
1940,232420,0,1,0,0,1,1,1
1941,232422,0,0,1,0,1,1,1
1942,232615,0,2,0,0,2,2,2
1943,232616,1,0,0,0,1,1,1
1944,392670,1,0,0,0,1,1,0
1945,233435,0,6,0,0,6,6,6
1946,232617,3,0,0,0,3,3,3
1947,232749,0,0,0,0,0,8,0
1948,232736,3,0,0,0,3,3,3
1949,232730,0,1,0,0,1,1,1
1950,232745,0,0,0,0,0,5,0
1951,232746,0,0,0,0,0,4,0
1952,232767,0,1,0,0,1,1,1
1953,232752,3,0,0,0,3,3,3
1954,232772,6,0,0,0,6,10,6
1955,232775,2,0,0,0,2,2,2
1956,232776,1,2,0,0,3,1,1
1957,232778,0,1,0,0,1,1,1
1958,392672,1,0,0,0,1,1,0
1959,232780,0,0,1,0,1,1,1
1960,233437,0,1,0,0,1,1,1
1961,233440,0,1,1,0,2,2,2
1962,233443,0,1,0,0,1,1,1
1963,233444,0,0,2,0,2,2,2
1964,233454,0,0,1,0,1,1,1
1965,233457,3,0,0,0,3,3,3
1966,233458,0,1,1,0,2,2,2
1967,235419,0,0,1,0,1,1,1
1968,235421,1,0,0,0,1,1,1
1969,235425,0,1,0,0,1,1,1
1970,235426,1,0,0,0,1,1,1
1971,235428,1,0,0,0,1,1,1
1972,235429,0,3,0,0,3,3,3
1973,235430,0,1,0,0,1,1,1
1974,235434,0,2,0,0,2,2,2
1975,235436,0,2,0,0,2,2,2
1976,235437,0,1,0,0,1,1,1
1977,235556,0,3,0,0,3,3,3
1978,235551,0,0,1,0,1,1,1
1979,235553,0,2,0,0,2,2,2
1980,235557,0,0,0,0,0,1,0
1981,235558,0,2,0,0,2,2,2
1982,235559,0,4,0,0,4,4,4
1983,235560,0,3,1,0,4,10,3
1984,235563,0,1,0,0,1,1,1
1985,235582,0,0,3,0,3,3,3
1986,235579,1,1,0,0,2,1,2
1987,235584,0,1,0,0,1,1,1
1988,235613,0,1,0,0,1,1,1
1989,235621,0,0,3,0,3,3,3
1990,235616,0,0,1,0,1,1,1
1991,235622,0,1,0,0,1,1,1
1992,235630,0,1,0,0,1,1,1
1993,235623,0,1,0,0,1,1,1
1994,235637,5,0,0,0,5,5,5
1995,235641,1,0,0,0,1,1,1
1996,246611,0,80,0,0,80,85,80
1997,238990,0,2,0,0,2,2,2
1998,238997,0,2,0,0,2,2,2
1999,239003,1,0,0,0,1,1,1
2000,239007,5,1,0,0,6,6,6
2001,239312,0,0,0,0,0,10,0
2002,246867,0,0,0,4,4,4,4
2003,239321,0,0,1,0,1,1,0
2004,239008,2,2,0,1,5,5,5
2005,239009,0,0,1,0,1,1,0
2006,239014,0,0,0,0,0,10,0
2007,239017,0,4,0,0,4,4,4
2008,239036,3,0,4,0,7,7,5
2009,239056,2,1,0,0,3,3,3
2010,239052,0,0,2,0,2,2,0
2011,239054,0,0,1,0,1,1,0
2012,239300,0,0,2,0,2,2,2
2013,239134,2,0,0,0,2,2,1
2014,239140,0,2,0,0,2,2,2
2015,239151,0,4,0,0,4,4,4
2016,239143,0,1,0,0,1,1,1
2017,239145,0,1,0,0,1,1,1
2018,239144,0,0,1,0,1,1,1
2019,239150,0,2,0,0,2,2,2
2020,252014,0,0,0,0,0,10,0
2021,239152,1,0,0,0,1,1,1
2022,239155,0,1,0,0,1,1,1
2023,239167,0,3,0,0,3,3,3
2024,239169,2,1,0,0,3,3,3
2025,239177,0,4,0,0,4,4,4
2026,239176,0,0,1,0,1,1,0
2027,239174,0,1,0,0,1,1,1
2028,239173,0,0,1,0,1,1,1
2029,239175,0,1,0,0,1,1,1
2030,239186,0,5,0,0,5,5,5
2031,239183,2,0,0,0,2,2,2
2032,239184,0,3,0,0,3,3,3
2033,239195,3,0,0,0,3,3,3
2034,239187,3,0,0,0,3,3,3
2035,239191,0,0,2,0,2,2,2
2036,239193,1,0,0,0,1,1,1
2037,239194,1,0,0,0,1,1,1
2038,239196,0,1,0,0,1,1,1
2039,239198,1,0,0,0,1,1,1
2040,239297,1,0,0,0,1,1,1
2041,239200,0,0,1,0,1,1,1
2042,239224,0,4,0,0,4,4,4
2043,239220,0,1,0,0,1,1,1
2044,239222,0,1,0,0,1,1,1
2045,246860,1,0,0,0,1,1,1
2046,239223,0,2,0,0,2,2,2
2047,239229,0,2,0,0,2,2,2
2048,239228,2,0,0,0,2,2,2
2049,239240,0,1,0,0,1,1,1
2050,239235,0,1,0,0,1,1,1
2051,239239,0,1,0,0,1,1,1
2052,239238,3,0,0,0,3,3,3
2053,246862,1,0,0,0,1,1,1
2054,246863,1,0,0,0,1,1,1
2055,246864,1,0,0,0,1,1,1
2056,239242,0,1,1,0,2,2,2
2057,246865,1,0,0,0,1,1,1
2058,246866,1,0,0,0,1,1,1
2059,239246,0,2,0,0,2,2,2
2060,239244,2,3,0,0,5,5,5
2061,239245,0,1,0,0,1,1,1
2062,239249,0,2,1,0,3,3,2
2063,239247,0,0,4,0,4,4,4
2064,239248,0,0,1,0,1,1,0
2065,252016,0,0,5,0,5,5,5
2066,239251,0,1,0,0,1,1,1
2067,239256,0,2,0,0,2,2,2
2068,239252,0,0,1,0,1,1,1
2069,239253,0,1,0,0,1,1,1
2070,239255,0,1,0,0,1,1,1
2071,239261,0,1,0,0,1,1,1
2072,239257,4,0,0,0,4,4,3
2073,239258,0,0,2,0,2,2,2
2074,239260,0,0,1,0,1,1,1
2075,239264,0,1,1,0,2,2,1
2076,239262,0,1,0,0,1,1,1
2077,239263,0,0,1,0,1,1,1
2078,239269,0,0,1,0,1,1,1
2079,239270,0,1,0,0,1,1,1
2080,392570,1,0,0,0,1,1,0
2081,246498,0,6,0,0,6,6,6
2082,246428,0,1,0,0,1,1,1
2083,392574,1,0,0,0,1,1,0
2084,246434,0,0,1,0,1,1,1
2085,392575,0,1,0,0,1,1,1
2086,246470,1,0,0,0,1,1,1
2087,246466,1,0,0,0,1,1,1
2088,246463,4,0,0,0,4,4,4
2089,246502,0,1,0,0,1,1,1
2090,246749,0,0,3,0,3,3,3
2091,246811,0,1,0,0,1,1,1
2092,246809,1,0,0,0,1,1,1
2093,246810,1,0,0,0,1,1,1
2094,246515,0,2,0,0,2,2,2
2095,246803,1,0,0,0,1,1,1
2096,246537,0,4,0,0,4,4,4
2097,246520,0,1,0,0,1,1,1
2098,246804,1,0,0,0,1,1,1
2099,246536,0,0,1,0,1,1,1
2100,246539,0,1,0,0,1,1,1
2101,246806,1,0,0,0,1,1,1
2102,246610,0,9,0,0,9,9,9
2103,246545,0,2,0,0,2,2,2
2104,246808,1,0,0,0,1,1,1
2105,246615,0,0,1,0,1,1,1
2106,246636,0,1,0,0,1,1,1
2107,246633,0,1,0,0,1,1,1
2108,246729,2,0,0,0,2,2,2
2109,246644,0,2,0,0,2,2,2
2110,246645,1,0,0,0,1,1,1
2111,246654,0,1,0,0,1,1,1
2112,246653,0,1,0,0,1,1,1
2113,246681,0,2,1,0,3,3,3
2114,392034,1,0,0,0,1,1,0
2115,246691,0,2,0,0,2,2,2
2116,246686,0,0,1,0,1,1,1
2117,246693,0,2,0,0,2,2,2
2118,392037,1,0,0,0,1,1,1
2119,392039,1,0,0,0,1,1,1
2120,246704,0,1,0,0,1,1,1
2121,246697,2,0,0,0,2,2,2
2122,246698,2,0,0,0,2,2,2
2123,246700,0,1,0,0,1,1,1
2124,246705,0,0,1,0,1,1,1
2125,246720,0,1,0,0,1,1,1
2126,249214,1,0,0,0,1,1,1
2127,246707,0,1,0,0,1,1,1
2128,249209,1,0,0,0,1,1,1
2129,248944,0,1,0,0,1,1,1
2130,248929,0,1,0,0,1,1,1
2131,248928,0,0,1,0,1,1,1
2132,249212,1,0,0,0,1,1,1
2133,249220,1,0,0,0,1,1,1
2134,248930,0,1,0,0,1,1,1
2135,248932,0,1,0,0,1,1,1
2136,248940,1,0,0,0,1,1,1
2137,249223,2,0,0,0,2,2,2
2138,249226,1,0,0,0,1,1,1
2139,248947,0,0,0,0,0,2,0
2140,248945,0,1,0,0,1,1,1
2141,249227,1,0,0,0,1,1,1
2142,248946,0,1,0,0,1,1,1
2143,248949,4,1,0,0,5,5,5
2144,248950,0,1,0,0,1,1,1
2145,248954,3,0,0,0,3,3,3
2146,249233,1,0,0,0,1,1,1
2147,249236,1,0,0,0,1,1,1
2148,248957,0,0,2,0,2,2,2
2149,249237,1,0,0,0,1,1,1
2150,249238,1,0,0,0,1,1,1
2151,249240,1,0,0,0,1,1,1
2152,249242,1,0,0,0,1,1,1
2153,275515,0,2,0,0,2,2,2
2154,315763,0,0,4,0,4,5,4
2155,257449,0,1,0,0,1,1,1
2156,257494,0,1,0,0,1,1,1
2157,275542,1,0,0,0,1,1,1
2158,275543,1,0,0,0,1,1,0
2159,275544,1,0,0,0,1,1,0
2160,275518,0,1,0,0,1,1,1
2161,258165,3,0,0,0,3,3,3
2162,275554,2,0,0,0,2,1,0
2163,257504,0,0,1,0,1,1,1
2164,258162,1,0,0,0,1,1,1
2165,257526,0,3,0,0,3,3,3
2166,258161,1,0,0,0,1,1,1
2167,258160,1,0,0,0,1,1,1
2168,275514,0,1,0,0,1,1,1
2169,258159,1,0,0,0,1,1,0
2170,258156,1,0,0,0,1,1,1
2171,258293,0,0,2,0,2,2,2
2172,275512,0,1,0,0,1,1,1
2173,258155,1,0,0,0,1,1,1
2174,258153,1,0,0,0,1,1,0
2175,258152,1,0,0,0,1,1,0
2176,257655,0,0,0,3,3,3,3
2177,257695,0,2,0,0,2,2,2
2178,258148,1,0,0,0,1,1,0
2179,258146,1,0,0,0,1,1,1
2180,257707,0,1,0,0,1,1,1
2181,258051,1,0,0,0,1,1,0
2182,258144,1,0,0,0,1,1,1
2183,257753,0,0,1,0,1,1,1
2184,257754,0,1,0,0,1,1,1
2185,257755,0,1,0,0,1,1,1
2186,259957,1,0,0,0,1,1,0
2187,257760,0,1,0,0,1,1,1
2188,257764,0,1,0,0,1,1,1
2189,257796,0,2,0,0,2,2,2
2190,257813,0,1,0,0,1,1,1
2191,257862,0,1,0,0,1,1,1
2192,275596,1,0,0,0,1,1,0
2193,275597,1,0,0,0,1,1,0
2194,257882,0,0,1,0,1,1,1
2195,257899,0,1,3,0,4,4,4
2196,257906,0,0,2,0,2,2,2
2197,257909,0,1,0,0,1,1,1
2198,257957,0,0,0,0,0,9,0
2199,257964,0,0,1,0,1,1,1
2200,257969,1,0,0,0,1,1,0
2201,258245,1,0,0,0,1,1,0
2202,275507,0,2,0,0,2,2,2
2203,275431,0,0,1,0,1,1,1
2204,275430,0,0,2,0,2,2,2
2205,257979,0,1,0,0,1,1,1
2206,257991,0,1,0,0,1,1,1
2207,257997,0,1,0,0,1,1,1
2208,258137,1,0,0,0,1,1,0
2209,258967,0,2,0,0,2,2,2
2210,275552,1,0,0,0,1,1,0
2211,258129,0,0,1,0,1,1,1
2212,259015,0,1,0,0,1,1,1
2213,259016,0,1,0,0,1,1,1
2214,258125,1,0,0,0,1,1,0
2215,259125,0,0,2,0,2,2,2
2216,259027,0,1,0,0,1,1,1
2217,258242,1,0,0,0,1,1,0
2218,258243,1,0,0,0,1,1,0
2219,259066,0,1,0,0,1,1,1
2220,258112,1,0,0,0,1,1,0
2221,258104,1,0,0,0,1,1,1
2222,258203,3,0,0,0,3,3,3
2223,259078,4,0,0,0,4,4,4
2224,275502,0,2,0,0,2,2,2
2225,259940,0,1,0,0,1,1,1
2226,259919,1,0,0,0,1,1,0
2227,275495,0,7,0,0,7,7,7
2228,275498,0,2,0,0,2,2,2
2229,263676,0,1,0,0,1,1,1
2230,275493,3,0,0,0,3,3,0
2231,263696,0,0,3,0,3,3,3
2232,264357,1,0,0,0,1,1,0
2233,263702,0,1,0,0,1,1,1
2234,263706,1,0,0,0,1,1,0
2235,275410,0,0,1,0,1,1,1
2236,264414,1,0,0,0,1,1,0
2237,263750,0,2,0,0,2,2,2
2238,264423,1,0,0,0,1,1,0
2239,264634,1,0,0,0,1,1,0
2240,264432,1,0,0,0,1,1,0
2241,264434,1,0,0,0,1,1,0
2242,264436,1,0,0,0,1,1,0
2243,266759,1,0,0,0,1,1,0
2244,275479,0,1,0,0,1,1,1
2245,266717,0,2,0,0,2,2,2
2246,266744,0,2,0,0,2,2,2
2247,266739,0,0,3,0,3,3,3
2248,266790,1,0,0,0,1,1,0
2249,266753,0,1,0,0,1,1,1
2250,266887,1,0,0,0,1,1,0
2251,270683,2,0,0,0,2,2,0
2252,275416,0,0,0,1,1,1,1
2253,271138,0,1,0,0,1,1,1
2254,266792,1,0,0,0,1,1,0
2255,275419,0,0,2,0,2,2,2
2256,271130,0,3,0,0,3,3,3
2257,275274,1,0,0,0,1,1,0
2258,275275,1,0,0,0,1,1,0
2259,275575,3,0,0,0,3,2,0
2260,271440,2,0,0,0,2,2,2
2261,275478,0,2,0,0,2,2,2
2262,275590,0,0,0,8,8,7,0
2263,275348,1,0,0,0,1,1,0
2264,275283,1,0,0,0,1,1,1
2265,275285,1,0,0,0,1,1,0
2266,275286,1,0,0,0,1,1,1
2267,275477,1,0,0,0,1,1,0
2268,325469,0,1,0,0,1,1,0
2269,422086,0,1,0,0,1,1,1
2270,304054,1,0,0,0,1,1,0
2271,289094,0,1,0,0,1,1,1
2272,422160,0,1,0,0,1,1,1
2273,422056,0,4,0,0,4,4,4
2274,315773,1,0,0,0,1,1,0
2275,315715,1,0,0,0,1,1,0
2276,289106,0,4,0,0,4,4,4
2277,289109,1,0,0,0,1,1,0
2278,289558,0,3,0,0,3,3,3
2279,289559,1,0,0,0,1,1,0
2280,315623,0,0,4,0,4,4,4
2281,289301,0,1,0,0,1,1,1
2282,304089,1,0,0,0,1,1,0
2283,289305,0,3,0,0,3,3,3
2284,422032,0,1,0,0,1,1,1
2285,421421,0,2,0,0,2,2,2
2286,289306,0,0,2,0,2,2,2
2287,289560,1,0,0,0,1,1,0
2288,289561,1,0,0,0,1,1,0
2289,289563,1,0,0,0,1,1,0
2290,289311,0,1,0,0,1,1,1
2291,289325,0,0,1,0,1,1,1
2292,421422,0,3,0,0,3,3,3
2293,289324,0,0,1,0,1,1,1
2294,289568,1,0,0,0,1,1,1
2295,315714,1,0,0,0,1,1,1
2296,289579,1,0,0,0,1,1,0
2297,289327,0,1,0,0,1,1,1
2298,289570,1,0,0,0,1,1,0
2299,289375,0,1,0,0,1,1,1
2300,289377,0,1,0,0,1,1,1
2301,289577,1,0,0,0,1,1,0
2302,289580,1,0,0,0,1,1,0
2303,421423,0,1,0,0,1,1,1
2304,289378,0,2,0,0,2,2,2
2305,289385,0,1,0,0,1,1,1
2306,289418,1,0,0,0,1,1,0
2307,289581,1,0,0,0,1,1,0
2308,421410,0,4,0,0,4,4,4
2309,289419,0,1,0,0,1,1,1
2310,289582,1,0,0,0,1,1,0
2311,289585,1,0,0,0,1,1,0
2312,421412,0,3,0,0,3,3,3
2313,289586,1,0,0,0,1,1,0
2314,289428,0,1,0,0,1,1,1
2315,304140,1,0,0,0,1,1,1
2316,289587,1,0,0,0,1,1,1
2317,421414,0,5,0,0,5,5,5
2318,421415,0,9,0,0,9,9,9
2319,289588,1,0,0,0,1,1,0
2320,289589,1,0,0,0,1,1,1
2321,421375,0,11,0,0,11,11,11
2322,304231,1,0,0,0,1,1,0
2323,289590,1,0,0,0,1,1,0
2324,289494,0,1,0,0,1,1,1
2325,289591,1,0,0,0,1,1,1
2326,289592,1,0,0,0,1,1,0
2327,289593,1,0,0,0,1,1,0
2328,289594,1,0,0,0,1,1,0
2329,421379,0,7,0,0,7,7,7
2330,421380,0,5,0,0,5,5,5
2331,289595,1,0,0,0,1,1,0
2332,421342,0,2,0,0,2,2,2
2333,301329,2,0,0,0,2,2,1
2334,301330,0,1,0,0,1,1,1
2335,301332,1,0,0,0,1,1,0
2336,301333,1,0,0,0,1,1,0
2337,301336,2,0,0,0,2,2,2
2338,421344,0,5,0,0,5,5,5
2339,421348,0,1,0,0,1,1,1
2340,315583,0,0,1,0,1,1,1
2341,301338,1,0,0,0,1,1,0
2342,301339,1,0,0,0,1,1,1
2343,301340,0,1,0,0,1,1,1
2344,315649,1,0,0,0,1,1,1
2345,421354,0,6,0,0,6,6,6
2346,315647,1,0,0,0,1,1,1
2347,421361,0,1,0,0,1,1,1
2348,421160,0,2,0,0,2,2,2
2349,303313,0,1,0,0,1,1,1
2350,303990,0,1,0,0,1,1,1
2351,303991,0,1,0,0,1,1,1
2352,303975,2,0,0,0,2,2,2
2353,303993,0,1,0,0,1,1,1
2354,315654,1,0,0,0,1,1,1
2355,421161,0,1,0,0,1,1,1
2356,304040,0,2,0,0,2,2,2
2357,304005,1,0,0,0,1,1,1
2358,304008,0,1,0,0,1,1,1
2359,304009,1,0,0,0,1,1,1
2360,304011,0,0,1,0,1,1,1
2361,304017,0,0,1,0,1,1,1
2362,304025,1,0,0,0,1,1,1
2363,304042,0,1,0,0,1,1,1
2364,304044,1,0,0,0,1,1,1
2365,304045,0,0,1,0,1,1,1
2366,315668,1,0,0,0,1,1,0
2367,315670,1,0,0,0,1,1,0
2368,315673,1,0,0,0,1,1,1
2369,421336,0,3,0,0,3,3,3
2370,304048,0,0,1,0,1,1,1
2371,304051,0,1,0,0,1,1,1
2372,304053,0,0,1,0,1,1,1
2373,421155,0,1,0,0,1,1,1
2374,300084,4,0,0,0,4,4,4
2375,421156,0,1,0,0,1,1,1
2376,307963,0,1,0,0,1,1,1
2377,307967,0,1,0,0,1,1,1
2378,307969,1,0,0,0,1,1,1
2379,307971,1,0,0,0,1,1,0
2380,421158,0,4,0,0,4,4,4
2381,308088,1,0,0,0,1,1,1
2382,308096,0,1,0,0,1,1,1
2383,308099,0,3,0,0,3,3,3
2384,308112,1,0,0,0,1,1,1
2385,421148,0,4,0,0,4,4,4
2386,308113,0,1,0,0,1,1,1
2387,308114,1,0,0,0,1,1,1
2388,315710,1,0,0,0,1,1,1
2389,315882,1,0,0,0,1,1,0
2390,308115,0,2,0,0,2,2,2
2391,308116,1,0,0,0,1,1,1
2392,308223,1,0,0,0,1,1,1
2393,308238,0,1,0,0,1,1,1
2394,421150,0,2,0,0,2,2,2
2395,315605,0,0,1,0,1,1,1
2396,315711,1,0,0,0,1,1,1
2397,315831,1,0,0,0,1,1,1
2398,315880,2,0,0,0,2,2,2
2399,308279,1,0,0,0,1,1,1
2400,308284,0,1,0,0,1,1,1
2401,308288,1,0,0,0,1,1,0
2402,421153,0,1,0,0,1,1,1
2403,308295,1,0,0,0,1,1,1
2404,308330,1,0,0,0,1,1,1
2405,308333,1,0,0,0,1,1,1
2406,421154,0,3,0,0,3,3,3
2407,315879,1,0,0,0,1,1,1
2408,315782,1,0,0,0,1,1,1
2409,315783,1,0,0,0,1,1,1
2410,315824,1,0,0,0,1,1,0
2411,315784,1,0,0,0,1,1,0
2412,421146,0,1,0,0,1,1,1
2413,315785,3,0,0,0,3,3,3
2414,315786,1,0,0,0,1,1,0
2415,315787,1,0,0,0,1,1,1
2416,315807,1,0,0,0,1,1,1
2417,421147,0,7,0,0,7,7,7
2418,315797,1,0,0,0,1,1,1
2419,315789,0,1,0,0,1,1,1
2420,421143,0,4,0,0,4,4,4
2421,324083,0,3,0,0,3,3,3
2422,324076,1,0,0,0,1,1,0
2423,324408,2,0,0,0,2,2,2
2424,324101,1,0,0,0,1,1,0
2425,421145,0,1,0,0,1,1,1
2426,324707,1,0,0,0,1,1,0
2427,324410,1,2,0,0,3,3,3
2428,421141,0,3,0,0,3,3,3
2429,324417,2,0,0,0,2,2,2
2430,324712,1,0,0,0,1,1,0
2431,324718,1,0,0,0,1,1,1
2432,421142,0,1,0,0,1,1,1
2433,324720,1,0,0,0,1,1,1
2434,324650,1,0,0,0,1,1,1
2435,324651,0,0,1,0,1,1,1
2436,324728,1,0,0,0,1,1,0
2437,324730,1,0,0,0,1,1,0
2438,338547,0,0,0,0,0,3,0
2439,421127,0,3,0,0,3,3,3
2440,338200,5,0,0,0,5,5,0
2441,338593,1,0,0,0,1,1,1
2442,338047,1,0,0,0,1,1,1
2443,338512,0,0,1,0,1,1,1
2444,338049,1,0,0,0,1,1,1
2445,338051,0,0,0,0,0,1,0
2446,338062,1,0,0,0,1,1,1
2447,338063,0,1,0,0,1,1,1
2448,338064,1,0,0,0,1,1,1
2449,338606,1,0,0,0,1,1,0
2450,338605,1,0,0,0,1,1,1
2451,338072,1,0,0,0,1,1,1
2452,421123,0,2,0,0,2,2,2
2453,338579,0,4,0,0,4,15,0
2454,421124,0,1,0,0,1,1,1
2455,421126,0,1,0,0,1,1,1
2456,338161,1,0,0,0,1,1,1
2457,338586,0,3,0,0,3,3,0
2458,338166,1,0,0,0,1,1,1
2459,338519,0,0,1,0,1,1,1
2460,338615,1,0,0,0,1,1,1
2461,338171,1,0,0,0,1,1,1
2462,338172,1,0,0,0,1,1,1
2463,338179,2,0,0,0,2,2,2
2464,349574,0,0,0,1,1,1,1
2465,338181,0,1,0,0,1,1,1
2466,338198,0,0,1,0,1,1,1
2467,338208,0,0,1,0,1,1,1
2468,338209,1,0,0,0,1,1,1
2469,338211,1,0,0,0,1,1,1
2470,376168,0,3,0,0,3,3,0
2471,376169,0,2,0,0,2,2,0
2472,376170,0,2,0,0,2,2,0
2473,376171,0,2,0,0,2,2,0
2474,338439,0,0,1,0,1,1,1
2475,338454,0,0,1,0,1,1,1
2476,359760,0,0,0,0,0,1,0
2477,338620,1,1,0,0,2,2,2
2478,366897,1,0,0,0,1,1,0
2479,343811,1,0,0,0,1,1,0
2480,343823,0,1,0,0,1,1,0
2481,343828,0,0,1,0,1,1,1
2482,350720,1,5,0,0,6,6,1
2483,421107,0,1,0,0,1,1,1
2484,376174,0,4,0,0,4,4,0
2485,376175,0,4,0,0,4,4,0
2486,344392,0,0,1,0,1,1,1
2487,344046,0,1,0,0,1,1,1
2488,421108,0,1,0,0,1,1,1
2489,421110,0,1,0,0,1,1,1
2490,343816,1,0,0,0,1,1,1
2491,350718,0,0,0,0,0,4,0
2492,344118,0,1,0,0,1,1,0
2493,376151,0,1,0,0,1,1,0
2494,421024,0,4,0,0,4,4,4
2495,349590,1,0,0,0,1,1,1
2496,349599,1,0,0,0,1,1,1
2497,349615,0,1,0,0,1,1,0
2498,349640,0,1,0,0,1,1,0
2499,350711,1,0,0,0,1,1,1
2500,349584,0,2,0,0,2,4,0
2501,349642,0,0,1,0,1,1,1
2502,349668,3,0,0,0,3,3,3
2503,349670,1,0,0,0,1,1,1
2504,349686,0,1,0,0,1,1,0
2505,349687,0,1,0,0,1,1,0
2506,349688,1,0,0,0,1,1,1
2507,349689,1,1,0,0,2,2,2
2508,349690,1,0,0,0,1,1,0
2509,390397,0,0,1,0,1,1,0
2510,354371,1,0,0,0,1,1,1
2511,354373,0,1,0,0,1,1,0
2512,359075,0,0,0,0,0,3,0
2513,390411,0,0,1,0,1,1,0
2514,366894,2,0,0,0,2,2,0
2515,366895,1,0,0,0,1,1,1
2516,366327,0,0,0,0,0,6,0
2517,390406,0,0,1,0,1,1,0
2518,366845,2,0,0,0,2,2,2
2519,372088,0,0,3,0,3,3,0
2520,371807,0,2,0,0,2,2,2
2521,372061,0,1,0,0,1,1,1
2522,372062,0,1,0,0,1,1,1
2523,420062,0,1,0,0,1,1,1
2524,371806,1,0,0,0,1,1,1
2525,372076,0,2,0,0,2,2,2
2526,420059,0,2,0,0,2,2,2
2527,374267,0,2,0,0,2,2,2
2528,379607,0,1,0,0,1,1,0
2529,379578,1,0,0,0,1,1,0
2530,379213,1,0,0,0,1,1,1
2531,379491,1,0,0,0,1,1,1
2532,379494,0,1,0,0,1,1,1
2533,385255,0,1,0,0,1,1,0
2534,379512,1,0,0,0,1,1,1
2535,384821,2,0,0,0,2,2,2
2536,384826,0,0,1,0,1,1,1
2537,384837,1,0,0,0,1,1,1
2538,384843,1,0,0,0,1,1,1
2539,384853,3,0,0,0,3,3,0
2540,385031,0,1,0,0,1,1,1
2541,385036,1,0,0,0,1,1,1
2542,385048,0,1,0,0,1,1,1
2543,385050,0,1,0,0,1,1,1
2544,385053,1,0,0,0,1,1,1
2545,390377,0,0,0,1,1,2,0
2546,402777,0,0,1,0,1,1,0
2547,389855,0,3,0,0,3,3,3
2548,389857,0,1,0,0,1,1,1
2549,389858,0,1,0,0,1,1,1
2550,389861,1,0,0,0,1,1,1
2551,389871,1,0,0,0,1,1,1
2552,389867,0,1,0,0,1,1,1
2553,390361,1,0,0,0,1,1,1
2554,420052,0,2,0,0,2,2,2
2555,389875,1,0,0,0,1,1,1
2556,389879,1,0,0,0,1,1,1
2557,390370,1,0,0,0,1,1,1
2558,389886,0,2,0,0,2,2,2
2559,389882,0,0,1,0,1,1,1
2560,389890,4,0,0,0,4,4,4
2561,396640,0,0,1,0,1,1,1
2562,389906,0,0,1,0,1,1,1
2563,420050,0,1,0,0,1,1,1
2564,389909,1,0,0,0,1,1,1
2565,396536,1,0,0,0,1,1,1
2566,396535,1,0,0,0,1,1,0
2567,395587,1,0,0,0,1,1,0
2568,395613,1,0,0,0,1,1,1
2569,395615,1,0,0,0,1,1,1
2570,395632,1,0,0,0,1,1,1
2571,401599,1,0,0,0,1,1,1
2572,395643,1,0,0,0,1,1,0
2573,395645,1,0,0,0,1,1,0
2574,395646,1,0,0,0,1,1,1
2575,395682,1,0,0,0,1,1,0
2576,395686,0,2,0,0,2,2,2
2577,395689,1,0,0,0,1,1,0
2578,396541,1,0,0,0,1,1,1
2579,401598,1,0,0,0,1,1,1
2580,420036,0,2,0,0,2,2,2
2581,395704,0,1,0,0,1,1,1
2582,401592,0,0,0,0,0,1,0
2583,402791,1,0,0,0,1,1,1
2584,401594,1,0,0,0,1,1,1
2585,401595,2,0,0,0,2,2,1
2586,401597,0,3,0,0,3,3,3
2587,401600,0,0,1,0,1,1,1
2588,401602,0,1,0,0,1,1,1
2589,401604,1,0,0,0,1,1,1
2590,420035,0,5,0,0,5,5,5
2591,402805,0,0,0,0,0,1,0
2592,402787,0,0,1,0,1,1,1
2593,405424,1,0,0,0,1,1,0
2594,404132,1,0,0,0,1,1,1
2595,405425,1,0,0,0,1,1,0
2596,420005,0,3,0,0,3,3,3
2597,404147,0,4,0,0,4,4,4
2598,404164,1,0,0,0,1,1,1
2599,405397,0,1,0,0,1,1,1
2600,408893,1,0,0,0,1,1,1
2601,408900,1,0,0,0,1,1,0
2602,408906,1,0,0,0,1,1,0
2603,408916,1,0,0,0,1,1,0
2604,409453,1,0,0,0,1,1,0
2605,408964,0,3,0,0,3,3,3
2606,408972,0,4,0,0,4,4,4
2607,419938,0,2,0,0,2,2,2
2608,409427,0,0,1,0,1,1,1
2609,413662,1,0,0,0,1,1,1
2610,413667,0,0,1,0,1,1,1
2611,419940,0,1,0,0,1,1,1
2612,413685,1,0,0,0,1,1,0
2613,413835,1,0,0,0,1,1,0
2614,413691,1,0,0,0,1,1,0
2615,413696,1,0,0,0,1,1,0
2616,413698,1,0,0,0,1,1,0
2617,413736,1,0,0,0,1,1,1
2618,419980,0,1,0,0,1,1,1
2619,415902,0,1,0,0,1,1,1
2620,419990,0,2,0,0,2,1,0
2621,428891,0,1,0,0,1,2,0
2622,419924,0,1,0,0,1,1,1
2623,419925,0,1,0,0,1,1,1
2624,419927,0,5,0,0,5,5,5
2625,423349,0,0,1,0,1,1,1
2626,423346,0,2,0,0,2,2,0
2627,423340,0,1,0,0,1,1,1
2628,423260,1,0,0,0,1,1,0
2629,423342,0,1,0,0,1,1,1
2630,423333,1,0,0,0,1,1,1
2631,423334,1,0,0,0,1,1,1
2632,423335,1,0,0,0,1,1,1
2633,425462,0,1,0,0,1,1,1
2634,425491,0,2,0,0,2,2,2
2635,425435,1,0,0,0,1,1,1
2636,425494,0,1,0,0,1,1,1
2637,425446,1,0,0,0,1,1,0
2638,425444,1,0,0,0,1,1,1
2639,236742,0,0,25,0,25,25,25
2640,429316,1,0,0,0,1,1,1
2641,429344,1,0,0,0,1,1,1
2642,429345,1,0,0,0,1,1,1
2643,204792,0,0,1,0,1,1,1
2644,236753,1,0,0,0,1,1,0
2645,429678,1,0,0,0,1,1,1
2646,429682,1,0,0,0,1,1,0
2647,429754,1,0,0,0,1,1,1
2648,204937,1,0,0,0,1,1,1
2649,429903,1,0,0,0,1,1,0
2650,429921,1,0,0,0,1,1,1
2651,204956,0,0,1,0,1,1,1
2652,433265,2,0,0,0,2,2,2
2653,433269,1,0,0,0,1,1,1
2654,236750,0,0,16,0,16,16,16
2655,205066,4,0,0,0,4,4,4
2656,211795,1,0,0,0,1,1,1
2657,211799,2,0,0,0,2,2,2
2658,236755,1,0,0,0,1,1,1
2659,236754,1,0,0,0,1,1,1
2660,211802,1,0,0,0,1,1,1
2661,211922,0,0,2,0,2,2,2
2662,211929,0,1,0,0,1,1,1
2663,236749,2,0,0,0,2,2,2
2664,211936,3,0,0,0,3,3,3
2665,218644,0,0,2,0,2,2,2
2666,218643,3,0,0,0,3,3,3
2667,218733,0,4,0,0,4,4,4
2668,236748,1,0,0,0,1,2,1
2669,236747,1,0,0,0,1,1,1
2670,225855,0,1,0,0,1,1,1
2671,225860,1,0,0,0,1,1,1
2672,225865,4,0,0,0,4,3,4
2673,232421,0,1,0,0,1,1,1
2674,232756,4,0,0,0,4,4,4
2675,233441,3,0,0,0,3,3,3
2676,236745,1,0,0,0,1,1,1
2677,235427,2,0,0,0,2,2,2
2678,235435,0,1,0,0,1,1,1
2679,236744,0,1,0,0,1,2,1
2680,246868,0,0,3,0,3,3,3
2681,239000,0,0,1,0,1,1,1
2682,239001,0,0,1,0,1,1,1
2683,239309,1,0,0,0,1,1,1
2684,239299,1,0,0,0,1,2,1
2685,252013,0,0,0,0,0,11,0
2686,239154,0,1,0,0,1,1,1
2687,239158,0,1,0,0,1,1,1
2688,239188,0,0,2,0,2,2,2
2689,239190,0,1,0,0,1,1,1
2690,239298,1,0,0,0,1,1,1
2691,239232,0,0,1,0,1,1,1
2692,246861,1,0,0,0,1,1,1
2693,239241,0,1,0,0,1,1,1
2694,239243,3,0,0,0,3,3,3
2695,252017,0,0,8,0,8,8,8
2696,239254,1,0,0,0,1,1,1
2697,239295,3,0,0,0,3,4,3
2698,239268,0,2,0,0,2,2,2
2699,392573,1,0,0,0,1,1,1
2700,246474,3,0,0,0,3,3,3
2701,246816,1,0,0,0,1,1,1
2702,246506,0,2,0,0,2,2,2
2703,246818,2,0,0,0,2,2,2
2704,246526,0,1,0,0,1,1,1
2705,246807,1,0,0,0,1,1,1
2706,252020,0,0,1,0,1,1,1
2707,252023,0,0,4,0,4,4,4
2708,246616,0,1,0,0,1,1,1
2709,246647,0,3,0,0,3,3,3
2710,249210,2,0,0,0,2,2,2
2711,249216,1,0,0,0,1,1,1
2712,248938,4,0,0,0,4,4,4
2713,249229,1,0,0,0,1,1,1
2714,249230,1,0,0,0,1,1,1
2715,249231,1,0,0,0,1,1,1
2716,315741,0,0,5,0,5,4,5
2717,275594,1,0,0,0,1,2,0
2718,275609,0,0,3,0,3,3,3
2719,258151,1,0,0,0,1,1,1
2720,275598,1,0,0,0,1,1,0
2721,257773,0,1,0,0,1,1,1
2722,264217,0,0,4,0,4,4,4
2723,257836,1,0,0,0,1,6,1
2724,257844,0,1,0,0,1,1,1
2725,257911,0,1,0,0,1,1,1
2726,275546,1,0,0,0,1,1,0
2727,275536,1,0,0,0,1,1,0
2728,257972,0,2,2,0,4,4,4
2729,258024,2,0,0,0,2,2,2
2730,275537,1,0,0,0,1,1,0
2731,275538,1,0,0,0,1,1,0
2732,259939,0,2,0,0,2,2,2
2733,259909,1,0,0,0,1,1,1
2734,259904,2,0,0,0,2,2,2
2735,264224,0,0,1,0,1,1,1
2736,263660,0,1,0,0,1,1,1
2737,275593,3,0,0,0,3,3,0
2738,263699,0,1,0,0,1,1,1
2739,263713,0,1,0,0,1,1,1
2740,275539,1,0,0,0,1,1,0
2741,275427,0,0,1,0,1,1,1
2742,263747,5,0,0,0,5,5,5
2743,275414,0,0,1,0,1,1,1
2744,264349,2,0,0,0,2,2,2
2745,264620,0,0,1,0,1,1,1
2746,275540,1,0,0,0,1,1,0
2747,275541,2,0,0,0,2,2,0
2748,266882,0,0,2,0,2,2,2
2749,275592,2,0,0,0,2,3,0
2750,275426,0,0,1,0,1,1,1
2751,271437,2,0,0,0,2,2,2
2752,271499,0,1,0,0,1,1,1
2753,275595,0,0,0,7,7,8,0
2754,275259,0,1,0,0,1,1,1
2755,289556,1,0,0,0,1,1,1
2756,289100,0,1,0,0,1,1,1
2757,325470,1,0,0,0,1,1,0
2758,289557,1,0,0,0,1,1,0
2759,315771,0,0,1,0,1,1,1
2760,325471,1,0,0,0,1,1,0
2761,289357,0,2,0,0,2,2,2
2762,289571,1,0,0,0,1,1,1
2763,289373,0,2,0,0,2,2,2
2764,325472,1,0,0,0,1,1,0
2765,315724,0,0,1,0,1,1,1
2766,301328,1,0,0,0,1,1,1
2767,325473,1,0,0,0,1,1,0
2768,303996,1,0,0,0,1,1,1
2769,304049,0,0,1,0,1,1,1
2770,315691,2,0,0,0,2,2,2
2771,304236,0,1,0,0,1,1,1
2772,308268,0,1,0,0,1,1,1
2773,308293,0,1,0,0,1,1,1
2774,308323,0,1,0,0,1,1,1
2775,315781,1,0,0,0,1,1,1
2776,315790,0,1,0,0,1,1,1
2777,315792,0,1,0,0,1,1,1
2778,324409,1,0,0,0,1,1,1
2779,324457,3,0,0,0,3,3,3
2780,376162,0,0,0,0,0,3,0
2781,376164,5,0,0,0,5,5,0
2782,338592,1,0,0,0,1,1,1
2783,338046,1,0,0,0,1,1,1
2784,338048,0,1,0,0,1,1,1
2785,338050,1,0,0,0,1,1,1
2786,338055,1,0,0,0,1,1,1
2787,338057,1,0,0,0,1,1,1
2788,338077,0,1,0,0,1,1,1
2789,338083,1,0,0,0,1,1,1
2790,376163,0,4,0,0,4,15,0
2791,338162,1,0,0,0,1,1,1
2792,338163,1,0,0,0,1,1,1
2793,376165,0,2,0,0,2,2,0
2794,338611,1,0,0,0,1,1,1
2795,338164,0,0,1,0,1,1,1
2796,338167,0,1,0,0,1,1,1
2797,338616,1,0,0,0,1,1,1
2798,338169,1,0,0,0,1,1,1
2799,338199,1,0,0,0,1,1,1
2800,338197,1,0,0,0,1,1,1
2801,338438,0,0,1,0,1,1,1
2802,338441,1,0,0,0,1,1,1
2803,338442,1,0,0,0,1,1,1
2804,338619,1,0,0,0,1,1,1
2805,343812,1,0,0,0,1,1,1
2806,376173,0,5,0,0,5,5,0
2807,343813,1,0,0,0,1,1,1
2808,343814,1,0,0,0,1,1,1
2809,343815,1,0,0,0,1,1,1
2810,350717,0,0,0,0,0,4,0
2811,376146,0,1,0,0,1,1,0
2812,343817,1,0,0,0,1,1,1
2813,349608,0,0,1,0,1,1,1
2814,366896,1,0,0,0,1,1,1
2815,376153,0,1,0,0,1,1,0
2816,350715,0,2,0,0,2,4,0
2817,349661,1,0,0,0,1,1,1
2818,349667,1,0,0,0,1,1,1
2819,376155,0,1,0,0,1,1,0
2820,354299,0,1,0,0,1,1,1
2821,354372,0,0,0,0,0,1,0
2822,376156,0,1,0,0,1,1,0
2823,376178,0,0,0,0,0,2,0
2824,390405,0,0,1,0,1,1,0
2825,358330,1,0,0,0,1,1,1
2826,366892,0,0,0,0,0,1,0
2827,376179,0,0,0,0,0,5,0
2828,374353,0,0,1,0,1,1,1
2829,374284,0,2,0,0,2,2,2
2830,425443,0,1,0,0,1,1,1
2831,379615,0,1,0,0,1,1,0
2832,379544,1,0,0,0,1,1,1
2833,402782,0,0,1,0,1,1,0
2834,385047,0,0,1,0,1,1,1
2835,385254,1,0,0,0,1,1,1
2836,402779,0,0,1,0,1,1,0
2837,389902,0,1,0,0,1,1,1
2838,395619,0,0,1,0,1,1,1
2839,396538,1,0,0,0,1,1,1
2840,395640,1,0,0,0,1,1,0
2841,395647,0,1,0,0,1,1,1
2842,395678,0,0,1,0,1,1,1
2843,396542,1,0,0,0,1,1,1
2844,401610,0,1,0,0,1,1,1
2845,401593,0,1,0,0,1,1,1
2846,401596,0,1,0,0,1,1,1
2847,401606,1,0,0,0,1,1,1
2848,405392,0,1,0,0,1,1,1
2849,408910,1,0,0,0,1,1,0
2850,409455,1,0,0,0,1,1,1
2851,409457,1,0,0,0,1,1,1
2852,408917,1,0,0,0,1,1,0
2853,413942,0,0,1,0,1,1,1
2854,413737,0,1,0,0,1,1,1
2855,415810,0,0,0,1,1,1,1
2856,415875,0,1,0,0,1,1,1
2857,419349,0,1,0,0,1,1,1
2858,423343,0,1,0,0,1,1,1
2859,423285,1,0,0,0,1,1,1
2860,423344,0,1,0,0,1,1,1
2861,425442,0,1,0,0,1,1,1
